拼音	词汇一	词汇二	...	词汇n
luoatan	罗阿坦
spdlsl	圣佩德罗苏拉
jdz	景德镇
rineiwa	日内瓦
kufula	库弗拉
jidagang	吉大港
kstc	康斯坦察
qiyan	七岩
tangjiatabudao	汤加塔布岛
danzhou	儋州
alade	阿拉德
hnmad	哈霓玛阿都
mangu	曼谷
guangshui	广水
kstw	卡斯塔韦
ainiweituokedao	埃尼威托克岛
wuzhong	吴忠
kstl	卡斯特里
jfs	加夫萨
eerguna	额尔古纳
awalua	阿瓦鲁阿
heersong	赫尔松
putaoya	葡萄牙
hebi	鹤壁
hmed	汉密尔顿
ssewd	圣萨尔瓦多
sikepuli	斯科普里
bhde	巴赫达尔
medw	摩尔多瓦
ganzi	甘孜
alaer	阿拉尔
yangzhou	扬州
jgm	基戈马
kaliba	卡里巴
yuehanneisibaoshi	约翰内斯堡市
jgs	井冈山
dazu	大足
yuedan	约旦
fuan	福安
nfkd(as)	诺福克岛(澳属)
kalibo	卡里波
wenshan	文山
yjde	亚加的尔
taiwan	台湾
liling	醴陵
daye	大冶
benekn	伯尔尼恩孔尼
xigong	西贡
kuzhan	苦盏
fandigangcheng	梵蒂冈城
kailuwan	凯鲁万
dengfeng	登封
medf	马尔代夫
shengpeideluosula	圣佩德罗苏拉
jiujiang	九江
jhs	九华山
taertu	塔尔图
amusitedan	阿姆斯特丹
pipidao	皮皮岛
enkayi	恩卡伊
niuafuou	纽阿福欧
bayamo	巴亚莫
bisha	比沙
gangguobu	刚果（布）
gaoan	高安
suqiawa	苏恰瓦
ajianni	阿基安尼
abxbl	阿布新比勒
ejmn	恩贾梅纳
famagusita	法马古斯塔
maliyawenquancheng	玛丽亚温泉城
dongdiwen	东帝汶
wulumuqi	乌鲁木齐
yilinjia	伊林加
qionglai	邛崃
engangdailei	恩冈代雷
fllsd	佛洛雷斯岛
aohuate	奥华特
meisi	梅斯
dazhou	达州
alblhqzg	阿拉伯联合酋长国
samaerhan	撒马尔罕
aedbld	阿尔达布拉岛
buleidaersiweike	布雷达尔斯维克
songyuan	松原
jbt	吉布提	贾巴特
jxnw	基希讷乌
dsedf	杜塞尔多夫
bijie	毕节
gongzhuling	公主岭
ashenbodun	阿什伯顿
misulata	米苏拉塔
hangzhou	杭州
doujiangyan	都江堰
bjxmt	巴基西梅托
kkqd	库克群岛
hegd	赫尔格达
naoludao	瑙鲁岛
yushu	榆树
jdc	基督城
changjiang	昌江
taishan	台山
hegs	哈尔格萨
jdg	吉大港
aiergehada	艾尔格哈达
aoerboyi	奥尔波依
yangjiaocun	羊角村
IRANSHAHR	IRANSHAHR	IRANSHAHR
kzl-ntes	夸祖鲁-纳塔尔省
jdl	基蒂拉
beiaierlan	北爱尔兰
yingtan	鹰潭
aitufei	艾图斐
kailuo	开罗
jms	佳木斯
hskst	哈萨克斯坦
jianeiliqundaoxi	加那利群岛（西）
jmd	甲米岛
badeng	巴登
lubange	卢班戈
sseqd	塞舌尔群岛
atebala	阿特巴拉
tamatafu	塔马塔夫
zhenjiang	镇江
jny	几内亚
annuobendao	安诺本岛
weiwei	维威
baisha	白沙
kslz	昆士兰州
fdgc	梵蒂冈城
zhucheng	诸城
bangguanu	邦瓜努
qinglai	清莱
silibajiawanshi	斯里巴加湾市
hulin	虎林
midiyaluodao	米蒂亚罗岛
sitelasibao	斯特拉斯堡
abaiang	阿拜昂
jnd	加拿大
aerboletasi	阿尔伯勒塔斯
kaichenggongyediqu	开城工业地区
tijikejia	提吉克贾
telonghaimu	特隆海姆
jnn	杰内纳
ledong	乐东
ruishiquanjing	瑞士全境
rnw	日内瓦
balidao	巴厘岛
bayangnei	巴扬内
hekf	哈尔科夫
rny	热内亚	热那亚
nuwakexiaote	努瓦克肖特
rsqj	瑞士全境
ensheerziweike	恩舍尔兹维克
bukawu	布卡武
shengyuehan	圣约翰
guanghan	广汉
kuibeikecheng	魁北克城
kuita	奎塔
asandiqu	阿散蒂区
chizhou	池州
jpz	柬埔寨
saersibao	萨尔斯堡
gantuoke	甘托克
nasao	拿骚
yuxian	蔚县
gansu	甘肃
hayimajiao	哈伊马角
weiliansitade	威廉斯塔德
twly	台湾旅游
aluodao	阿洛岛
yingde	英德
plwsaks	普罗旺斯埃克斯
helong	和龙
foluoleisi	佛罗雷斯
jianyang	建阳	简阳
rln	日利纳
rlm	热雷米
munihei	慕尼黑
chongsheng	冲绳
rld	热浪岛
bopulade	波普拉德
jilin	吉林
rkz	日喀则
lamuanla	拉姆安拉
saerte	萨尔特
beiermalite	贝尔马立特
aeyf	阿尔约夫
aluotao	阿洛淘
bosite	博斯特
jjs	旧金山
jjl	基加利
dbdq	东部地区
jjd	京畿道
aosikasihamen	奥斯卡斯哈门
hubei	湖北
panzhihua	攀枝花
ahuasi	阿华斯
njlg	尼加拉瓜
jla	加鲁阿
blbnsbd	波罗奔尼萨半岛
btltl	布塔里塔里
diqing	迪庆
eerxinji	俄尔辛基
bamake	巴马科
moxige	墨西哥
jnlqdx	加那利群岛（西）
suomali	索马里
aimai	埃迈
hltfd	赫鲁特方丹
hulunbeier	呼伦贝尔
beiergelaide	贝尔格莱德
huhuyi	胡胡伊
guixi	贵溪
angela	安哥拉
blgwssk	布拉戈维申斯克
jlm	吉灵庙
lgagla	拉戈阿格里奥
jlp	吉隆坡
nwxbesk	诺沃西比尔斯克
jld	基利岛
yisifahan	伊斯法罕
funafuti	富纳富提
aedbl	阿尔达比勒
laibin	来宾
xiaoyi	孝义
aeryuefu	阿尔约夫
saiyidebuer	赛义德布尔
pulandian	普兰店
ailate	埃拉特
mengtelier	蒙特利尔
jixinewu	基希讷乌
dengzhou	邓州
qiandaohu	千岛湖
xianggelila	香格里拉
alajipu	阿拉吉普
chaozhou	潮州
xintela	新特拉
shengpiaierhemikelongdao	圣皮埃尔和密克隆岛
balinasi	巴里纳斯
qiwayu	齐瓦余
chongshengxian	冲绳县
alajiaersasi	阿拉加尔萨斯
zhalantun	扎兰屯
akaligua	阿卡里瓜
xingcheng	兴城
eltly	厄立特里亚
asezhen	阿瑟镇
shanxi	山西	陕西
fashuguiyanei	法属圭亚那
aluona	阿罗纳
guoluo	果洛
metd	马耳他岛
lier	里尔
danbulongqu	淡布隆区
haergesa	哈尔格萨
fandigang	梵蒂冈
nikexiya	尼科西亚
kayan	卡宴
ningbo	宁波
ktdw	科特迪瓦
lltjd	拉罗汤加岛
liangping	梁平
kkqdx	库克群岛（新）
shengtaoshadao	圣淘沙岛
bagelong	巴格隆
wanlong	万隆
aewd	埃尔韦德
gaomi	高密
moersibigang	莫尔斯比港
jejsst	吉尔吉斯斯坦
shengjiciheniweisi	圣基茨和尼维斯
ningde	宁德
hanchuan	汉川
mkkljlb	马可可拉俱乐部
palaxiaosi	帕拉西奥斯
matinikefa	马提尼克（法）
huangnan	黄南
heergeda	赫尔格达
ablays	阿布雷奥约斯
flqd	法罗群岛
hongshishi	红石市
dblq	淡布隆区
paermaer	帕尔马尔
zoucheng	邹城
bowei	博韦
dbls	德布勒森	第比利斯
rsf	热舒夫
bulawayue	布拉瓦约
jilibasi	基里巴斯
ble/fle	博伦厄/法鲁恩
kankun	坎昆
nuofukedao(aoshu)	诺福克岛(澳属)
mseqd	马绍尔群岛
pulalandao	普拉兰岛
bazhalutequndao	巴扎鲁特群岛
luoanda	罗安达
guadeluopu(fashu)	瓜德罗普(法属)
ezhou	鄂州
dangyang	当阳
nanning	南宁
xiangnong	香农
boliwaerzhou	玻利瓦尔州
moyou	莫尤
budan	不丹
esezwk	恩舍尔兹维克
bingdao	冰岛
anldpl	阿努拉德普勒
namibiya	纳米比亚
beiliu	北流
laofoye	老佛爷
saercibao	萨尔茨堡
butalitali	布塔里塔里
maolun	毛伦
shangyu	上虞
shiyan	十堰
xiaogan	孝感
jisumu	基苏木
duolunduo	多伦多
yiwu	义乌
bfjjsp	班夫及贾斯珀
geerfeituo	戈尔菲托
aerweisikeer	阿尔维斯克尔
awns	埃沃内斯
jnybs	几内亚比绍
luowaniemi	罗瓦涅米
lpds	兰佩杜萨
ddwmzghg	东帝汶民主共和国
bpld	波普拉德
ludun	鲁顿
limini	里米尼
aishen	埃申
libiliya	利比里亚
taicang	太仓
sbd	塞班岛
sbh	塞布哈
ganzhou	赣州
suwa	苏瓦
beimaliyaneiqundao	北马里亚那群岛
aolu	奥卢
sbl	圣保罗
kls(jlb)	库拉索(加勒比)
papiti	帕皮提
beidaihe	北戴河
sat	圣安唐
yamusukeluo	亚穆苏克罗
lijiana	里加纳
gaoer	高尔
lijiang	丽江
agenting	阿根廷
zhanghai	长海
suwu	宿雾
xibanyagang	西班牙港
bdlg(ms)	波多黎各(美属)
huaibei	淮北
sdgem	斯德哥尔摩
tanpeilei	坦佩雷
awla	阿瓦鲁阿
akerute	阿克茹特
macheng	麻城
aierbixiya	埃尔比希亚
dimishenwala	蒂米什瓦拉
aoladiya	奥拉迪亚
qiwang	奇旺
baoting	保亭
matadi	马塔迪
sglb	萨格勒布
bafuluode	巴夫洛德
lima	利马
aelye	埃尔雷亚尔
jiashan	嘉善
danzili	丹兹利
yili	伊犁
kukequndaoxin	库克群岛（新）
huangjinhaian	黄金海岸
yichang	宜昌
jiande	建德
fcyl	富查伊拉
ptkedy	皮特凯恩岛（英）
chuankuang	川圹
bogendi	博艮地
buyinuosiailisi	布宜诺斯艾利斯
alanuka	阿拉努卡
lusaien	卢塞恩
feicheng	肥城
dafeng	大丰
neigelagang	内格拉港
aehs	奥尔胡斯
flkf	法兰克福
aegs	埃尔贡山
jepp	居尔皮普
heshuandeliesi	荷属安的列斯
mosangbike	莫桑比克
xining	西宁
huaian	淮安
yima	义马
walemi	瓦勒米
bdlgm	波多黎各（美）
djdp	东加大埔
fushan	釜山
tabaka	塔巴卡
maluekadao	马略卡岛
kaiping	开平
hanguo	韩国
yamaijia	牙买加
aedsg	奥尔达斯港
alubahe	阿鲁巴（荷）
danjier	丹吉尔
aisibao	埃斯堡
tsmny	塔斯马尼亚
ouyun	欧云
puyang	濮阳
agewa	阿格瓦
tongjiang	同江
douyun	都匀
lplg	伦皮拉港
aerbaniya	阿尔巴尼亚
aeje	阿尔及尔
saerwaduo	萨尔瓦多
zhaoyuan	招远
bojiafuyuedueryisiteli	博加福约杜尔－伊斯特里
tuluzi	图卢兹
guayajier	瓜亚基尔
meihekou	梅河口
awny	埃维纳永
flls	佛罗雷斯	佛罗伦萨
wjbsk	维捷布斯克
banfujijiasipo	班夫及贾斯珀
banbali	班巴里
sikabole	斯卡伯勒
haiyang	海阳
sdygd	圣地亚哥岛
xingyi	兴义
haibei	海北
tieermeizi	铁尔梅兹
anda	安达
shishou	石首
dongyang	东阳
abeixie	阿贝歇
boao	博鳌
zhangchun	长春
lwepd	拉瓦尔品第
shs	圣何塞
lengshuijiang	冷水江
slwny	斯洛文尼亚
yushan	蔚山
bogeda	波哥大
dalian	大连
tunisi	突尼斯
hlbe	呼伦贝尔
buliesite	布列斯特
suihua	绥化
sfy	索非亚
shenqieqing	什切青
jialajiasi	加拉加斯
sgl	苏格兰
khtlyew	科赫特拉亚尔韦
sgd	塞格德
walunxiya	瓦伦西亚
apataji	阿帕塔基
malanre	马兰热
malakaer	马拉卡尔
smlns	圣马力诺市
ysfh	伊斯法罕
anbd	安诺本岛
wlsyftnf	瓦利斯与富图纳（法）
heerxinji	赫尔辛基
bjnfs	布基纳法索
qlmzl	乞力马扎罗
huaxin	华欣
shamen	厦门
bibulusizhubaile	比卜鲁斯（朱拜勒）
shz	石河子
bhagws	滨海奥果韦省
jingdou	京都
yuanjiang	沅江
lujianuo	卢加诺
gelinglan	格陵兰
andeneisi	安德内斯
beihaidao	北海道
xuanwei	宣威
bimini	比米尼
neiluobi	内罗毕
taiguo	泰国
guangyuan	广元
yintelaken	因特拉肯
hlgl	霍林郭勒
aebxy	埃尔比希亚
kel	库尔勒
boen	波恩
lasiweijiasi	拉斯维加斯
kes	凯恩斯
boer	博尔
shafuhaosen	沙芙豪森
aiergongshan	埃尔贡山
sdm	圣多美
kex	卡尔希
andongniaogang	安东尼奥港
youningqundao	尤宁群岛
plxas	帕拉西奥斯
alzmd	奥兰治蒙德
mianyang	绵阳
mishan	密山
dongying	东营
heilongjiang	黑龙江
aerbeisishanmai	阿尔卑斯山脉
dlzdgd	达兰扎达嘎德
ktmks	卡塔马卡省
tongxiang	桐乡
kfl	库弗拉
liuniwang(fashu)	留尼汪(法属)
jllbd	贾拉拉巴德
flmte	弗里曼特尔
reneiya	热内亚	热那亚
set	萨尔特
yadesiyabeiba	亚的斯亚贝巴
hlel	哈拉尔林
shouguang	寿光
zhaipuer	斋普尔
sfh	绥芬河
aidefu	埃德夫
bolishi	玻璃市
fnft	富纳富提
haidelaba	海得拉巴
nuwadibu	努瓦迪布
makekelajulebu	马可可拉俱乐部
bkfyde	巴卡夫约多尔
edkh	恩德卡汗
beilute	贝鲁特
bhapzm	贝亨奥普佐姆
kdh	坎大哈
leping	乐平
fuding	福鼎
kdn	卡杜纳
sed	萨尔岛
klpd	克莱佩达
nisi	尼斯
kdw	坎达武
niboer	尼泊尔
mdyld	米蒂亚罗岛
honghe	红河
wulagui	乌拉圭
baganga	巴岗阿
agela	阿哥拉	阿格拉
dunniecike	顿涅茨克
doulasi	都拉斯
duoha	多哈
kasama	卡萨马
mosuer	摩苏尔
jiatetu	佳特土
tunxi	屯溪
donggang	东港
klny	科洛尼亚	凯里尼亚
kasanei	卡萨内
baiduoa	拜多阿
shennongjia	神农架
shangqiu	商丘
sslnj	塞萨洛尼基
zhengzhou	郑州
duoge	多哥
gelimusai	格里姆塞
sailaliang	塞拉利昂
geermu	格尔木
bayinguolengmengguzizhizhou	巴音郭楞蒙古自治州
abtmyd	安巴图迈茵蒂
ktlk	科特赖克
abumusa	阿布穆萨
klmy	克拉玛依
kpd	开普敦
asdplad	阿斯蒂帕莱阿岛
wshy	乌斯怀亚
ydnxy	印度尼西亚
saigede	塞格德
dnblbdlfsk	第聂伯罗彼得罗夫斯克
daweide	达维德
bokasideertuoluo	博卡斯德尔托罗
sewd	萨尔瓦多
sqz	圣乔治
suer	素尔	苏尔
shengsaerwaduo	圣萨尔瓦多
afuhan	阿富汗
sqw	苏恰瓦
tanboer	坦博尔
dongbudiqu	东部地区
hdlb	海得拉巴
jiafusa	加夫萨
kspxw	康塞普西翁
sqq	什切青
nangong	南宫
bangte	邦特
jialua	加鲁阿
sewy	塞尔维亚
wuzhishan	五指山
hapayi	哈帕伊
wuxian	吴县
blglld	巴拉哥劳拉多
endepei	恩德培
kpl	坎帕拉	堪培拉
sll	塞拉莱	沙拉拉
niyajiala	尼亚加拉
gaoya	高亚
batiya	芭提雅
klkf	克拉克福	克拉科夫
kmx	库马西
weiershi	威尔士
sln	苏里南	索里诺
sls	塞卢斯	苏黎世	苏黎士
yisinei	伊斯那
aosuoernuo	奥索尔诺
nrly	尼日利亚
dubuluofunike	杜布罗夫尼克
meixian	梅县
wzbkst	乌兹别克斯坦
fmgst	法马古斯塔
kmd	科摩多
wjdg	瓦加杜古
bakelalan	巴克拉兰
hdls	洪都拉斯
keerduowa	科尔多瓦
lbeyn	卢布尔雅那
befst	贝尔法斯特
kmg	卡马圭
kml	喀麦隆	科摩罗
sld	索罗蒂	萨兰达
slg	斯利哥
saluonika	萨洛尼卡
shanghai	上海
knt	康诺特
kns	考纳斯
ystbe	伊斯坦布尔
kekesibazhaer	科克斯巴扎尔
bierdoudaleer	比尔都达勒尔
skl	苏克雷
deban	德班
kny	肯尼亚	科尼亚
yanbian	延边
kenakeli	科纳克里
skt	斯库台
abuludaisi	阿布鲁代斯
waerpalaisuo	瓦尔帕莱索
sjz	石家庄
kbkc	魁北克城
knj	卡纳角
astjc	埃斯特角城
mdlqdp	马德拉群岛（葡）
bulagansa	布拉干萨
yucheng	禹城
tekesihekaikesiqundao	特克斯和凯科斯群岛
haboluonei	哈博罗内
aboluo	阿波洛
zhuji	诸暨
luotadao	罗塔岛
kkd	科科岛
peilujia	佩鲁贾
quanzhou	泉州
snj	神农架
fukelanqundao	福克兰群岛
kkl	科科拉
ludelici	吕德里茨
snf	少女峰
ajiajiali	阿加贾里
gannan	甘南
klw	凯鲁万
klr	克卢日
klq	卡拉奇
fuzhou	抚州	福州
sml	索马里
smy	萨摩亚
smx	三门峡
sesb	萨尔斯堡
kle	科罗尔
awaw	阿武阿武
sly	沙捞越
slz	设拉子
klb	克里比	卡里巴	卡里波
kld	科罗岛
klm	克莱蒙
klp	卡鲁普	科伦坡
lanpini	蓝毗尼
hengbin	横滨
liwensidun	利文斯敦
klj	凯里郡	卡龙加
smd	苏梅岛	圣马丁
klgf	克拉根福
sws	苏瓦市
kangsitancha	康斯坦察
xiangtan	湘潭
bfllq	布法罗兰奇
abujia	阿布贾
bulao	布劳
xiamuni	夏慕尼
puning	普宁
nwkxt	努瓦克肖特
zqx	长崎县
hannuowei	汉诺威
fenghuang	凤凰
aisibiyue	埃斯比约
zhuozhou	涿州
jyg	嘉峪关
swy	沙娃伊
jyd	江原道
yangquan	阳泉
duominijia	多米尼加
mesbg	莫尔斯比港
bokeluo	博科罗
kalaqi	卡拉奇
mltd	马莱塔岛
hanzhong	汉中
lingshui	陵水
ystb	伊斯坦堡
syd	塞伊达
huazhou	化州
klgd	卡拉干达
awalei	阿瓦雷
aertamila	阿尔塔米拉
beijing	北京
ztd	长滩岛
shengduomingge	圣多明各
linxi	林西
fangchenggang	防城港
sys	双鸭山
syh	圣约翰
suqian	宿迁
talawa	塔拉瓦
baganni	巴感尼
jwg	鲸湾港
peipi	佩皮
lubomo	卢博莫
linyi	临沂
aeklk	阿尔卡雷克
mlqs	毛里求斯
szs	石嘴山
jinan	济南
xeht	锡尔赫特
taneineilifo	塔那那利佛
bahama	巴哈马
mnxjqd	马尼希基群岛
buyou	布尤
kldy	克罗地亚
algyn	阿拉瓜依纳
huilingdun	惠灵顿
peiqi	佩奇
saibandao	塞班岛
asstt	艾森史塔特
sse	塞舌尔
mlxy	马来西亚
jtw	基特韦
jtt	佳特土
yidou	宜都
beiergaomu	贝尔高姆
mlyq	马来奕区
ajiadezi	阿加德兹
wlmalq	文莱－穆阿拉区
fuquan	福泉
jsm	基苏木
baoleisi	包雷斯
shatealabo	沙特阿拉伯
kaimanqundaoying	开曼群岛（英）
fegn	费尔干纳
diaobingshan	调兵山
jingmen	荆门
mlwy	蒙罗维亚
lianzhou	连州
aidingbao	爱丁堡
anbosaili	安波塞利
jss	金沙萨
henan	河南
aftl	阿富塔拉
zhangtandao	长滩岛
sts	圣淘沙
renchuan	仁川
nuosalabiqi	诺萨拉比奇
babaduosi	巴巴多斯
xiangcheng	项城
huanglong	黄龙
nandaihe	南戴河
bhede	巴哈尔达尔
xwzmqq	西乌珠穆沁旗
wulanchabu	乌兰察布
aokelan	奥克兰
feisalabade	费萨拉巴德
mnsls	马尼萨莱斯
liancheng	连城
sihui	四会
jiuhuashan	九华山
latanajili	腊塔纳基里
zxs	直辖市
jsd	金斯敦
pingdingshan	平顶山
lanbaleinei	兰巴雷内
jse	杰索尔
kebosi	克波斯
sflp	圣费利佩
weinan	渭南
bangge	邦戈
neigelier	内格里尔
foluolunsa	佛罗伦萨
liezhidunshideng	列支敦士登
bfsm	巴富萨姆
chaerba	查尔巴
mengtelei	蒙特雷
kbs	克波斯
sngl	圣尼古拉
batongshi	巴统市
sulishi	苏黎世	苏黎士
datian	大田
zhaoqing	肇庆
aewske	阿尔维斯克尔
kekesiqundao	科科斯群岛
kbd	卡宾达	科布多
kbe	喀布尔
wajiadugu	瓦加杜古
litaowan	立陶宛
sfks	斯法克斯
danyang	丹阳
henei	河内
tbk	塔巴卡
anlu	安陆
tbd	停泊岛
tbe	坦博尔
lbxqd	拉巴西群岛
jiyate	基亚特
malibo	马里博
shihezi	石河子
shenyang	沈阳
honghu	洪湖
mashenhade	马什哈德
zhongwei	中卫
yslb	伊斯兰堡
jiexiu	介休
stwg	斯塔万格
pingxiang	凭祥	萍乡
hxqy	华欣七岩
lageageliao	拉戈阿格里奥
nijialagua	尼加拉瓜
niriliya	尼日利亚
bamenda	巴门达
shengtuolinidao	圣托里尼岛
hlyk	胡利亚卡
qixia	栖霞
snje	塞内加尔
duonigeer	多尼戈尔
kukequndao	库克群岛
tbt	通布图
yulin	榆林	玉林
weifang	潍坊
qianjiang	潜江
guanaha	瓜纳哈
fulajimier	弗拉基米尔
alutuya	阿鲁图亚
longquan	龙泉
weilakelala	维拉克拉拉
libanen	黎巴嫩
bangbu	蚌埠
balagui	巴拉圭
daman	达曼
anji	安吉
huangshan	黄山
maqidun	马其顿
bmlynqd	北马里亚那群岛
sfhs	沙芙豪森
jierjisisitan	吉尔吉斯斯坦
mikeluonixiya	密克罗尼西亚
sukelei	苏克雷
jiabate	贾巴特
aerbaihelei	阿尔拜赫雷
malabo	马拉博
changzhou	常州
mklnxy	密克罗尼西亚
taizigang	太子港
bole	博乐
boergeershan	博尔戈尔山
lechang	乐昌
boli	波里
telongmuse	特隆姆瑟
sncx	神奈川県
dahela	达赫拉
mubabanei	姆巴巴内
linken	林肯
gualier	瓜里尔
dusaierduofu	杜塞尔多夫
ktwz	卡托维兹
dongxing	东兴
linbei	林贝
meixi	美西
stsd	圣淘沙岛
luoding	罗定
manaosi	玛瑙斯
lisiben	里斯本
pengzhou	彭州
aermeiniya	阿尔梅尼亚
bfld	巴夫洛德
gaizhou	盖州
bxly	巴西利亚
alaierta	阿莱尔塔
wasa	瓦萨
niuaixin	纽埃（新）
jzg	九寨沟
jzd	济州岛
edcc	讹答刺城
aoerdasigang	奥尔达斯港
tingbodao	停泊岛
keqiabanba	科恰班巴
kulasuo(jialebi)	库拉索(加勒比)
dengta	灯塔
wanuatu	瓦努阿图
kabinda	卡宾达
shunhua	顺化
yangjiang	阳江
gaoping	高平
jyt	基亚特
aierguoleia	埃尔果累阿
yzme	伊兹密尔
gedebao	歌德堡	哥德堡
juerpipu	居尔皮普
zanbiya	赞比亚
bke	巴克尔
katumu	喀土穆
xierte	锡尔特
mtnkf	马提尼克（法）
kmsl	卡米什利
bjy	贝贾亚
jincheng	晋城
bjx	班加西
aqlb	安其拉贝
jiangxi	江西
aerdabuladao	阿尔达布拉岛
ruichang	瑞昌
wujiang	吴江
bjs	班加索	布加斯
aierlan	爱尔兰
beilingdi	北领地
bjn	比基尼
wanzhou	万州
jieneina	杰内纳
bjl	巴佳拉	本贾里
qingjin	清津
salarewo	萨拉热窝
malaixiya	马来西亚
dmswl	蒂米什瓦拉
shengduomeihepulinxibi	圣多美和普林西比
ajianiya	阿加尼亚
ptktd	彭特科特岛
temz	铁尔梅兹
huainan	淮南
gdlpf	瓜德罗普（法）
yuehanneisibao	约翰内斯堡
tmld	塔马林德
botou	泊头
kangnuote	康诺特
stjt	斯图加特
labate	拉巴特
hejin	河津
bmd	百慕大	巴门达
wtlz	乌特勒支
gbhg	哥本哈根
bmh	伯明翰
elebulu	厄勒布鲁
kaiensi	凯恩斯
blz	伯利兹
blt	博洛陶	贝鲁特
telisenbeige	特里森贝格
blr	布鲁日
wafangdian	瓦房店
bls	比利时	包雷斯	玻璃市
kandawu	坎达武
blx	伯拉西
haiyan	海盐
asaao	阿萨奥
blw	布拉瓦	巴拉望
bll	贝拉里	巴雷拉	巴拉莱
blm	博拉马
blj	布拉加
zhili	智利
niukasier	纽卡斯尔
weisaya	维萨亚
blb	贝莱比
ble	巴莱尔
zuailate	祖埃拉特
bld	布隆迪	布莱顿	巴厘岛	布莱德	北领地	布雷达
blg	巴拉圭	布拉格	布拉干	波来古
jiaonan	胶南
maokaidao	毛凯岛
luanping	滦平
bociwana	博茨瓦纳
labasi	拉巴斯
bojipuxi	波基普西
changji	昌吉
ninghai	宁海
asuosa	阿索萨
kabuer	喀布尔
bkw	布卡武	巴克乌
zek	扎尔卡
bkl	博科罗	博卡拉
bkm	巴库马
yseqdp	亚速尔群岛（葡）
basangkusu	巴桑库苏
zby	赞比亚
akeluodili	阿克罗蒂里
qinzhou	钦州
wujiaqu	五家渠
pds	平顶山
leshan	乐山
wdml	危地马拉
bns	博南萨
wdms	乌多姆塞
bnp	波纳佩
bnm	巴拿马
deyang	德阳
klksd	科里科斯岛
hah	胡安惠
xintai	新泰
klksg	卡拉克斯港
bolin	柏林
linghai	凌海
tlsbg	特里森贝格
bnc	贝宁城
wdlc	五大连池
lfnm	罗凡涅米
knlns	卡内洛内斯
zde	扎达尔
bandundu	班顿杜
bne	博奈尔
qiongzhong	琼中
baonajiaer	包纳加尔
bmq	贝米齐
awaladamu	阿瓦拉达姆
gesidalijia	哥斯达黎加
bmk	巴马科
bmn	巴莫尼	比米尼
jiutai	九台
changli	昌黎
stlj	斯特鲁加
wdly	维多利亚
bmy	巴米扬
jdmslc	加达梅斯老城
napd	南安普顿
duolun	多伦
xintianebao	新天鹅堡
ahld	奥赫里德
hcw	海参崴
liyang	溧阳
wugeku	吴哥窟
relangdao	热浪岛
telinidaheduobage	特立尼达和多巴哥
jinyun	缙云
nananpudun	南安普顿
chengdou	成都
banmeisuaote	班梅苏奥特
gelaci	格拉茨
akaliguala	阿卡里瓜拉
huanggang	黄冈
byybn	巴依亚比纳
benxi	本溪
bpl	柏培拉
boduoligemei	波多黎各（美）
kailiniya	凯里尼亚
bachu	巴楚
haicanwei	海参崴
hdb	海德堡
huzhimingshi	胡志明市
talin	塔林
hdj	海地角
bbl	班巴里
zhangjiakou	张家口
antaliya	安塔利亚
diwate	蒂瓦特
kemt	库尔马特
bbj	布巴基
kalupu	卡鲁普
mingguang	明光
qidong	启东
heneishi	河内市
lianyungang	连云港
heb	哈尔滨
xuancheng	宣城
halifakesi	哈利法克斯
huoniyala	霍尼亚拉
linxiang	临湘
lkywk	雷克亚未克	雷克雅未克
hes	赫尔松
keluodao	科罗岛
wtfd	沃特福德
zpe	斋普尔
hongdoulasi	洪都拉斯
aerhesaima	阿尔荷塞马
chuxiong	楚雄
pgb	帕古巴
meishan	眉山
lalibeila	拉利贝拉
wdhk	温得和克
yining	伊宁
baa	巴阿
weilagang	维拉港
honghaiyanan	红海沿岸
bilong	比隆
ningguo	宁国
zhixiashi	直辖市
walisiyufutunafa	瓦利斯与富图纳（法）
baihan	拜汉
batanjiafu	巴坦加弗
langzhong	阆中
nanfei	南非
gdlhl	瓜达拉哈拉
bdk	巴蒂卡
baojialiya	保加利亚
kasitawei	卡斯塔韦
zlt	扎兰屯
bdd	班顿杜	伯德岛
peipiniang	佩皮尼昂
maoliqiusi	毛里求斯
bdh	北戴河
shunde	顺德
boertawa	波尔塔瓦
boluosidao	波罗斯岛
kekela	科科拉
pfs	帕福斯
jinbian	金边
yibao	怡保
zmd	驻马店
bdw	巴德望
yyxz	依云小镇
swsthglnds	圣文森特和格林纳丁斯
estsd	厄斯特松德
bdy	芭堤雅
xinglong	兴隆
boaweisita	博阿维斯塔
fuxin	阜新
pdw	帕多瓦
nirier	尼日尔
dianbianfu	奠边府
hhy	胡胡伊
pen	帕尔努
lnwf	留尼旺（法）
hhz	皇后镇
bda	拜多阿
tonglu	桐庐
baierwa	拜尔瓦
laiyang	莱阳
qujing	曲靖
betw	波尔塔瓦
bolan	波兰
sumendaladao	苏门答腊岛
baimudaying	百慕大（英）
plk	帕伦克
baidikeluo	拜蒂克洛
plj	佩鲁贾
shizuishan	石嘴山
bfl	邦福拉
yuncheng	运城
pld	普兰店	彭林岛
maerduonaduo	马尔多纳多
abeimamahuanjiao	阿贝马马环礁
pls	帕劳市
yazhuang	芽庄
baimuda	百慕大
dhlkqd	达赫拉克群岛
asabu	阿萨布
bga	巴岗阿
beimiqi	贝米齐
bgb	比格贝
xisha	西沙
bgd	巴格达	波哥大	博艮地
ply	普拉亚
longkou	龙口
tieling	铁岭
lwlet	里韦拉尔塔
fafadao	法法岛
yibin	宜宾
gg(j)	刚果(金)
beg	卑尔根
mengtegang	蒙特港
bodiansike	柏迪安斯克
jilingmiao	吉灵庙
bed	博恩代	波尔多
bufaluolanqi	布法罗兰奇
tasimaniya	塔斯马尼亚
weijiebusike	维捷布斯克
beq	贝尔齐
lasaileina	拉塞雷纳
ben	布尔诺	伯尔尼
changde	常德
buergenlanzhou	布尔根兰州
kandaha	坎大哈
wltzz	乌拉特中镇
bew	拜尔瓦
bet	波尔图
bfc	北方城
aierweide	埃尔韦德
keke	科克
mandalegebi	曼达勒戈壁
keka	科卡
pingliang	平凉
loudi	娄底
msgwn	墨塞哥维那
bhm	巴哈马
bhl	布哈拉
xiahe	夏河
pjd	普吉岛
lswjs	拉斯维加斯
keks	卡尔卡松
xinzhou	忻州
xixilidao	西西里岛
hle	海拉尔
yunnan	云南
hld	葫芦岛	惠灵顿
fljme	弗拉基米尔
zixing	资兴
dushangbie	杜尚别
bgl	本格拉	巴格隆
chidaojineiya	赤道几内亚
bozinan	波兹南
hlj	黑龙江
aoerjin	奥尔金
hll	哈拉雷
bgn	邦瓜努	巴感尼
jiangyuandao	江原道
jiangshan	江山
bexb	贝尔谢巴
hlt	赫拉特
baluo	巴罗
zhouzhuang	周庄
shannan	山南
guliyefu	古里耶夫
zjg	张家港	芝加哥
kemo	科莫
liyade	利雅得
zhongshan	中山
zjk	张家口
zjj	张家界
aermeinala	阿尔梅纳拉
bhd	北海道
gbed	甘比尔岛
bakuma	巴库马
xfed	谢菲尔德
qingshuihe	清水河
feilubin	菲律宾
bamoni	巴莫尼
diyabakeer	迪亚巴克尔
qinyang	沁阳
tansangniya	坦桑尼亚
bzm	博佐姆
bzn	波兹南
wotaihua	渥太华
liuyang	浏阳
zhibuluotuo	直布罗陀
gls	甘露市
bze	班珠尔
nuodinghan	诺丁汉
boertu	波尔图
gle	瓜里尔
ankala	安卡拉
gll	格陵兰
bethlw	波尔托海利翁
atake	阿塔克
gylml	瓜亚拉梅林
glc	格拉茨
kksbze	科克斯巴扎尔
bigebei	比格贝
hktg	哈科特港
ppt	帕皮提
gongyi	巩义
baishan	白山
aerpuerke	阿尔普尔科
zhadaer	扎达尔
aijiersitadier	埃吉尔斯塔第尔
qilimazhaluo	乞力马扎罗
shengjiciheniweisilianbang	圣基茨和尼维斯联邦
buna	布纳
ppd	皮皮岛
linqing	临清
mazhalishalifu	马扎里沙里夫
boshasuo	博沙索
xiongyali	匈牙利
yswejqd	英属维尔京群岛
fumosa	福莫萨
beta	贝尔图阿
beglz	布尔根兰州
yongzhou	永州
shaoyang	邵阳
weiduoliya	维多利亚
salanda	萨兰达
tangshan	唐山
zhade	乍得
buleixiya	布雷西亚
maota	毛塔
cjnl	昌金努拉
sanmenxia	三门峡
gnh	瓜纳哈
yss	亚松森
ysn	伊斯那
nabataqu	纳巴塔区
shuozhou	朔州
samoya	萨摩亚
ysl	以色列
pnk	普那卡
gms	戈马市
niyamei	尼亚美
gml	戈梅利
bolune/faluen	博伦厄/法鲁恩
shengwensentehegelinnadingsi	圣文森特和格林纳丁斯
renqiu	任丘
qiemo	且末
guangxi	广西
chengmai	澄迈
bolizi	伯利兹
psd	派桑杜
boluoniya	博洛尼亚
gg(b)	刚果(布)
xinshan	新山
pty	葡萄牙
gpb	甘蓬碧
yancheng	盐城
bemh	贝尔梅霍
akela	阿克拉
moxi	莫希
estlf	俄斯特拉发
guiping	桂平
bels	白俄罗斯
mositaer	莫斯塔尔
ptl	帕特雷
tacheng	塔城
zibo	淄博
atanbua	阿坦布阿
xxld	西西里岛
kelikesidao	科里科斯岛
xuchang	许昌
esitesongde	厄斯特松德
ayuelasi	阿约拉斯
tongcheng	桐城
wuan	武安
aefse	埃尔法舍尔
miandian	缅甸
lukesuo	卢克索
bajiximeituo	巴基西梅托
kuitun	奎屯
hymj	哈伊马角
xingning	兴宁
nanchong	南充
guantaneimo	关塔那摩
luliang	吕梁
alianqiu	阿联酋
jmnzg	吉梅内兹港
tongzhou	通州
banjiasuo	班加索
keniya	科尼亚
mengdeweideya	蒙得维的亚
puluowangsiaikesi	普罗旺斯埃克斯
agly	安圭拉（英）
tmtf	塔马塔夫
lanzhou	兰州
brl	巴茹拉
bilun	比伦
keerhuoge	科尔霍戈
bazhang	巴章
gaobeidian	高碑店
dongduo	栋多
lasaiwa	拉塞瓦
balamita	巴拉米塔
tmsk	图木舒克
baniyaluka	巴尼亚卢卡
awldm	阿瓦拉达姆
bnmc	巴拿马城
anqing	安庆
shelazi	设拉子
lawaerpindi	拉瓦尔品第
bsl	巴士拉
bsk	巴斯克
mengluoweiya	蒙罗维亚
gtk	甘托克
aiweinong	艾维浓
kahamaerka	卡哈马尔卡
bsd	波士顿
fulangxisidun	弗朗西斯敦
bse	巴塞尔	伯赛恩	贝沙尔
bsg	巴松戈
boerni	伯尔尼
beks	巴尔喀什
bnje	包纳加尔
bsw	白沙瓦
balin	巴林
huaying	华蓥
bss	博沙索
bst	博斯特
dunhuang	敦煌
wulanhaote	乌兰浩特
yilihasakezizhizhou	伊犁哈萨克自治州
btn	巴图纳	巴特纳
btm	比塔姆
btl	布塔雷	班特里
aiaisi	埃埃斯
siluofake	斯洛伐克
xxdxg	西峡（大峡谷）
haicheng	海城
nslbq	诺萨拉比奇
niriwa	尼日瓦
silige	斯利哥
bty	芭提雅
qqhe	齐齐哈尔
maidina	麦地纳
bts	巴统市
lushan	庐山
esitelafa	俄斯特拉发
wlxy	瓦伦西亚
aetml	阿尔塔米拉
huayin	华阴
beges	博尔戈尔山
xiangxiang	湘乡
mingsike	明斯克
ruidian	瑞典
bdask	柏迪安斯克
suoluomenqundao	所罗门群岛
xiwuzhumuqinqi	西乌珠穆沁旗
aiweinayong	埃维纳永
baerkashen	巴尔喀什
akesu	阿克苏
blfec	布鲁菲尔茨
kanuo	卡诺
mishenkeerci	密什科尔茨
yameiniya	亚美尼亚
xuzhou	徐州
gyn	圭亚那
klstcq	克赖斯特彻奇
zhuanghe	庄河
kelong	科隆
laotuokashi	劳托卡市
tongshen	通什
binhaiaoguoweisheng	滨海奥果韦省
aolinpiya	奥林匹亚
bedl	巴尔代雷
kelaisitecheqi	克赖斯特彻奇
bwk	布瓦凯
rikaze	日喀则
venice	venice	venice
wutai	五台
zhangzhi	长治
begld	贝尔格莱德
ankang	安康
keweitecheng	科威特城
hezhou	贺州
bulage	布拉格
malaluoqisi	马拉洛奇斯
huining	会宁
begm	贝尔高姆
mxgc	墨西哥城
liaoyang	辽阳
shlny	圣赫勒拿（英）
sangjibaer	桑给巴尔
nafo	纽阿福欧
pzh	攀枝花
zhongfei	中非
dxal	大兴安岭
shuangyashan	双鸭山
ywd	雅温得
pingrang	平壤
sdmjplxb	圣多美及普林西比
shangzhi	尚志
ypfd	英普丰多
antuofajiasita	安托法加斯塔
bincheng	槟城
xinkaliduoniyafa	新喀里多尼亚（法）
bym	巴亚莫
byn	巴扬内
kanpeila	堪培拉
gzd	戈佐岛
foluoleisidao	佛洛雷斯岛
boliweiya	玻利维亚
wuduomusai	乌多姆塞
gzl	公主岭
fz	丰镇	抚州	福州
beian	北安
shaoguan	韶关
longmudao	龙目岛
fx	阜新
fy	富蕴	富阳	汾阳	阜阳
gc	刚察	藁城
beby	巴尔博亚
gd	关岛	广东	广岛	高当
ge	高尔
jiaozhou	胶州
ga	广安	高安
gb	古巴
shennaichuanxian	神奈川県
fk	阜康
fj	斐济	富锦	福建
lwnm	罗瓦涅米
danmaifaluoqundaodan	丹麦法罗群岛（丹）
fl	芬兰	法鲁
fg	法国
nanping	南平
bebe	毕尔巴鄂
fh	凤凰	奉化
fs	佛山	抚顺	非斯	釜山
chuntian	春天
fn	丰南	丰宁
fq	福泉
becs	巴尔策斯
gy	固原	巩义	广元	贵阳	高要	高邮	高亚
gz	广州	甘孜	盖州	贵州	赣州	高州	光州
nbls	纳布卢斯	那不勒斯
gx	广西	贵溪
ayls	阿约拉斯
hf	合肥	海法	海防
hg	韩国	鹤岗	黄冈
hd	海地	化德	桦甸	海东	邯郸	豪岛
he	候恩
chugefeng	楚格峰
hb	河北	海北	淮北	湖北	鹤壁	赫本	汉堡	横浜	横滨
hc	汉川	河池	海城	珲春	韩城
lunpilagang	伦皮拉港
ha	淮安	会安
gn	甘南
gm	高密
gl	果洛	桂林
gj	个旧	古交	甘贾
jiesuoer	杰索尔
gh	广汉	根河
gg	贵港	戈公
gt	根特
dashiqiao	大石桥
gs	广水	甘肃
mosaigeweinei	墨塞哥维那
keweiha	科维哈
gp	桂平	高平
aiji	埃及
lajieshaxi	拉杰沙希
dt	东台	大同	灯塔	大田
liang	里昂
shuangcheng	双城
dx	东兴	定西	德兴	达县
dy	东营	东阳	丹阳	大冶	当阳	德阳	都匀
mtslty	蒙特塞拉特（英）
dz	儋州	大足	定州	德州	达州	邓州
nanyang	南阳
enshi	恩施
yiguasu	伊瓜苏
danjiangkou	丹江口
bemsd	巴尔马塞达
pabl	普埃布拉
dd	丹东	德岛	栋多
dg	德国	多哥	东港	东莞
humusi	胡姆斯
df	东方	大丰	登封
ydl	意大利
dh	德宏	德惠	敦化	敦煌	多哈
dk	达卡
dj	东京
dm	丹麦	达曼
mssmy	美属萨摩亚
dl	多伦	大理	大连	达拉
ahs	阿华斯
bahaerdaer	巴哈尔达尔
aht	奥华特
niuatuoputapu(dao)	纽阿托普塔普(岛)
dq	大庆	德清	迪庆
hetian	和田
ahq	阿合奇
yds	雁荡山
ds	迪石
dr	第戎
kasikayisi	卡斯卡伊斯
saiyida	塞伊达
mflk	马夫拉客
agw	阿格瓦
penglindao	彭林岛
ez	鄂州
bzltqd	巴扎鲁特群岛
fa	福安
ahe	阿赫
fd	福鼎
jegd	加尔各答
fc	丰城	凤城	肥城
agl	安哥拉	阿哥拉	阿格拉
neibulesi	那不勒斯
sailebabi	塞勒巴比
ep	恩平
daban	大阪
beibi	北碧
tulufan	吐鲁番
agt	阿根廷
liaocheng	聊城
es	恩施
dongdiwenminzhugongheguo	东帝汶民主共和国
cb	赤壁
qdn	黔东南
bz	亳州	巴中	滨州	霸州	巴章
barula	巴茹拉
jingjiang	靖江
bw	博韦
jlbs	基里巴斯
by	白银	布尤
bx	巴西	本溪
bs	保山	白山	白沙	百色	比绍	比萨	比沙	巴色	巴斯
kmqdy	开曼群岛（英）
qdh	千岛湖
mdwdy	蒙得维的亚
laibixi	莱比锡
bt	保亭	包头	泊头	贝图	邦特	巴塔
anx	安纳西	阿纳西
bn	贝宁	北宁	贝尼	布纳
bp	北票	北帕
bq	包齐
bj	北京	宝鸡	毕节	班吉	本吉	宝礁
bk	博凯	巴库
bl	巴林	波兰	巴罗	北流	博乐	比劳	比伦	比隆	贝鲁	柏林	巴黎	布劳	波里
bm	八莫
saer	撒尔
bg	邦戈	博盖	巴甘
bh	波黑	北海	拜汉
bksdetl	博卡斯德尔托罗
bb	蚌埠	本巴	北碧
bc	巴楚	白城	博城	槟城
bd	不丹	冰岛	保定	贝达	巴登
kaliyakudao	卡里亚库岛
be	博尔	波恩
dc	大城
db	德班	大阪	迪拜
milan	米兰
da	大安	定安
jiamidao	甲米岛
labaxiqundao	拉巴西群岛
ank	阿那科
jgsggdq	金刚山观光地区
palamalibo	帕拉马里博
taixing	泰兴
cz	崇州	崇左	常州	池州	沧州	滁州	潮州	郴州
cy	昌邑	朝阳
cx	朝鲜	岑溪	慈溪	楚雄
ana	阿纳
anb	安纳巴
ct	春天
teguxijiaerba	特古西加尔巴
cs	常熟	赤水	冲绳
lanxi	兰溪
cm	澄迈
cn	常宁
wlmq	乌鲁木齐
banzhuer	班珠尔
ck	川圹
cl	昌黎
cj	昌吉	昌江
beida	贝达
manhadun	曼哈顿
ch	从化	巢湖
yalishanda	亚历山大
dakaer	达喀尔
cf	赤峰
jiangyin	江阴
cd	常德	成都	承德	昌都
amh	阿马海
wlkll	维拉克拉拉
xiantao	仙桃
wlkls	维拉克鲁斯	维兰库卢什
xwyz	夏威夷州
ama	阿马
mohe	漠河
suwashi	苏瓦市
wuchuan	吴川
ayhw	埃因霍温
aly	阿鲁亚	阿莱亚
alw	埃里温	阿洛维
shengdiyage	圣地亚哥
jianou	建瓯
tlndhdbg	特立尼达和多巴哥
alt	阿勒泰	埃拉特	阿洛淘
jeky	加尔卡尤
als	阿拉善	阿鲁沙	奥勒松
alq	阿联酋
alp	阿勒颇
haketegang	哈科特港
aln	阿罗纳
all	阿卢拉
alk	阿劳卡
ali	阿里	阿利
ay	安阳	艾因
ba	北安	博鳌	宝安	巴阿
ald	阿洛岛	阿拉德
ale	阿拉尔
meikeneisi	梅克内斯
at	阿提
wusu	乌苏
as	安顺	鞍山	埃申	埃森
ala	阿洛阿	阿拉
aq	安丘	安庆
alb	阿鲁巴
ak	安康
al	安陆	阿里	阿利	奥卢	阿拉	奥兰
bolama	博拉马
aj	埃及	安吉
aks	阿克苏
kelibi	克里比
am	阿曼	澳门	阿马	埃迈	安曼
an	安宁	阿纳
akt	阿克套
xiaweiyi	夏威夷
ac	阿城
ad	安达
baiyin	白银
ab	阿坝	阿包
ag	安国
ah	安徽	阿赫
anaxi	阿纳西
jiamusi	佳木斯
akl	阿克拉	安卡拉	阿库雷	奥克兰
aba	阿坝	阿拜昂
nt	南通	南特
ns	南沙	拿骚	尼斯
abd	阿巴丹	阿伯丁
nq	那曲
kenniya	肯尼亚
np	南平
abh	艾卜哈
luyigang	路易港
nn	南宁
beilaibi	贝莱比
abj	阿布贾
bdyb	布蒂亚巴
abl	阿波洛
ny	南阳	纽约
nx	南雄	宁夏	南希
blwy	玻利维亚	布拉瓦约
kaipudun	开普敦
alakaqie	阿拉卡茄
nw	挪威
tielishixueshan	铁力士雪山
qhd	秦皇岛
abr	阿比让
shenfang	什邡
ykb	亚喀巴
abt	安巴托
sumeidao	苏梅岛
boduolige(meishu)	波多黎各(美属)
xibudiqu	西部地区
abx	阿贝歇
zhuhai	珠海
shengweisente	圣维森特
sitelujia	斯特鲁加
nukualuofa	努库阿洛法
yks	牙克石
sichuan	四川
fushun	抚顺
aak	埃阿坎
antiguahebabuda	安提瓜和巴布达
delw	迪尔伦湾
oy	欧云
aas	埃埃斯
pd	平度
yld	幽灵岛
pe	普洱
bakafuyueduoer	巴卡夫约多尔
pg	蒲甘
shengluxiya	圣卢西亚
blwc	波罗维茨
ylh	茵莱湖
pb	庞贝	彭巴
pc	浦城
wlht	乌兰浩特
ylj	伊林加
pl	帕劳	帕罗	平凉	蓬莱	普拉
ylk	伊拉克
pn	普宁
byhge	巴颜洪格尔
ph	平湖	彭亨
nbtq	纳巴塔区
pj	盘锦
lianjiang	廉江
ln	辽宁	陇南
blslgn	布鲁斯拉古纳
lm	洛美	罗马	利马
fengnan	丰南
ll	乐陵	吕梁	醴陵
ls	丽水	乐山	凉山	庐山	拉萨	离石	陵水	罗索	兰斯	洛桑	琉森
lq	临清	乐清	鹿泉	龙泉
lp	乐平	梁平	滦平	黎平
lw	老挝	灵武	莱芜	佬沃
bdwd	伯顿伍德
lz	兰州	林州	林芝	柳州	泸州	莱州	连州	阆中	雷州	罗兹
huade	化德
ly	临沂	凌源	洛阳	浏阳	涟源	溧阳	耒阳	莱阳	辽源	辽阳	龙岩	龙游
lx	临夏	临湘	兰溪	林西	潞西	莱西
ningan	宁安
ymj	牙买加
guiyanei	圭亚那
mc	麻城
shanwei	汕尾
md	缅甸
mg	蒙古	美国	明光	曼谷
mh	漠河
wukelan	乌克兰
wuhu	芜湖
aoerhusi	奥尔胡斯
tlblk	图利布洛克
changjinnula	昌金努拉
luomeili	罗梅利
ml	秘鲁	马里	汨罗	毛伦	米兰	马累
mj	麦加
wengehua	温哥华
mazhuluo	马朱罗
mm	茂名	孟买
sikutai	斯库台
balaier	巴莱尔
kanajiao	卡纳角
wlstd	威廉斯塔德
beierfasite	贝尔法斯特
mq	米泉
mt	毛塔
ms	密山	眉山	芒市	梅斯	马赛
mx	梅县	莫希	美西
ERBIL	ERBIL	ERBIL
knkl	科纳克里
mw	马翁
haidebao	海德堡
mz	孟州	梅州	绵竹
blxy	布雷西亚
my	绵阳	茫崖	莫尤
cemate	策马特
na	南安	宁安	南澳
nb	宁波
nc	南充	南昌
nd	宁德	南迪	楠迪
nf	南非	南法
ng	南宫	宁国
nh	南海	宁海	讷河
blyl	贝拉耶拉
nj	内江	南京	怒江	牛津
nk	南康
hbln	哈博罗内
nl	瑙鲁
nm	涅马
jx	介休	嘉兴	江西	鸡西
jy	姜堰	建阳	揭阳	江油	江阴	济源	简阳	缙云
blst	巴勒斯坦	布列斯特
bokai	博凯
gyje	瓜亚基尔
puer	普洱
jt	九台	金坛	加特	加途
jr	句容
ataer	阿塔尔
js	吉首	嘉善	江山	江苏	津市	界首	加沙
jp	加蓬
jq	酒泉	剑桥
luomaniya	罗马尼亚
afh	阿富汗
jn	加纳	济南	济宁	胶南	集宁	戛纳
jo	建瓯
jl	吉林
jm	即墨	江门	荆门	甲米
jj	九江	晋江	靖江
afl	阿佛雷
jk	捷克
guangdong	广东
blte	布兰太尔
kg	科戈
gebenhagen	哥本哈根
kf	开封
ygl	英格兰
hjha	黄金海岸
bonaier	博奈尔
kc	库车
bulawa	布拉瓦
ssbygj	莎士比亚故居
mikenuosidao	米克诺斯岛	米科诺斯岛
bosaien	伯赛恩
tuolaiduo	托莱多
tianmen	天门
lwsd	利文斯敦
jz	冀州	晋中	晋州	焦作	胶州	荆州	锦州
aen	阿尔诺
mubandaka	姆班达卡
dedao	德岛
ky	开原	开远	卡宴
heshan	合山	鹤山
ael	爱尔兰
kz	苦盏
ks	喀什	昆山	喀山
aes	阿尔山	阿尔索
jiangyan	姜堰
kt	奎屯	凯塔	奎塔	康提
kaluoweifali	卡罗维发利
adelaide	阿德莱德
kp	开平
nyjl	尼亚加拉
aed	奥尔岛
kk	昆卡	科卡	坎昆	科克
keweite	科威特
kl	凯里	开罗	科隆
aej	奥尔金
ygs	伊瓜苏
km	昆明	科莫
bierbae	毕尔巴鄂
maaidao	马埃岛
kn	卡诺
blsd	波罗斯岛
tunchang	屯昌
lh	临河	临海	凌海	漯河	龙海	洛哈
blsb	布里斯班
lk	龙口	林肯
lj	临江	丽江	廉江	龙井	里加
le	里尔
ld	乐东	娄底	罗定	林迪	伦敦	鲁顿
lg	临高
lf	临汾	廊坊	陆丰
blse	巴里萨尔	布鲁塞尔
kailijun	凯里郡
la	临安	六安	里昂	鲁昂
katuoweizi	卡托维兹
lc	临沧	乐昌	利川	潞城	聊城	连城	林茨
aet	阿尔塔	奥尔塔	阿尔泰
lb	来宾	灵宝	林贝
huian	会安
hs	合山	衡水	鹤山	黄山	黄石	华沙	会晒
jinjiang	晋江
quzhou	衢州
adl	奥地利	安杜洛
ht	和田
pengteketedao	彭特科特岛
hj	河津	河间	洪江	黑角
mayoudao	马尤岛
hk	海口	哈克
hh	怀化	洪湖	红河	黄骅	黑河	黑赫
hn	河南	海南	海宁	淮南	湖南	黄南	会宁	河内
hl	荷兰	和龙	海伦	海林	虎林	黄龙
kumaxi	库马西
adf	埃德夫
ade	安道尔
hm	侯马	哈密	海门
hancheng	韩城
limasuoer	利马索尔
maisuncheng	麦孙城
aeb	奥尔堡
ngle	内格里尔
atage	阿塔格
bulaidun	布莱顿
atebasaer	阿特巴萨尔
nglg	内格拉港
xijin	锡金
langbolabang	朗勃拉邦	琅勃拉邦
hz	化州	合作	徽州	惠州	杭州	汉中	湖州	菏泽	贺州	霍州
hy	华蓥	华阴	河源	海盐	海阳	淮阴	衡阳	黄岩	海牙
hx	海西	辉县	华欣
ads	敖德萨
haerkefu	哈尔科夫
suzidali	苏滋达里
zhongguo	中国
hengbang	横浜
gsdlj	哥斯达黎加
haifang	海防
kaowenchui	考文垂
maneigua	马那瓜
yaan	雅安
jc	晋城	金昌
adb	爱丁堡
jb	金边
sudan	苏丹
je	杰尔	基尔
jd	建德	江都	基多	京都	吉达
bengela	本格拉
siping	四平
jf	基辅	基法
jh	景洪	蛟河	金华
ailukedao	艾芦克岛
mengtele	蒙特勒
qml	曲麻莱
ja	吉安	集安
yjd	雅加达
yjc	羊角村
xj	锡金	新疆	辛集
azm	阿治曼
xh	兴化	夏河
abasigang	阿巴斯港
xn	兴宁	咸宁	西宁	悉尼	香农
liangshan	凉山
hpy	哈帕伊
xl	希腊	兴隆	新乐
xm	新密	新民
xs	西沙	象山	小松	新山
blwnw	贝拉乌尼翁
xp	兴平
xw	宣威	希瓦
xt	仙桃	新泰	湘潭	邢台
teluxiluo	特鲁西洛
wz	万州	吴忠	梧州	温州
wy	万源	婺源	武义
wx	吴县	无锡	武穴	万象
ww	武威	维威
bozhou	亳州
xc	兴城	宣城	新昌	西昌	许昌	项城
xa	兴安	西安
xg	孝感	香港	西贡
bjlst	布加勒斯特
xf	襄樊
wg	武冈	舞钢	维哥
shouer	首尔
wh	乌海	卫辉	威海	武汉	芜湖
enping	恩平
wj	吴江
mzlslf	马扎里沙里夫
wl	文莱	温岭	万隆
amupala	阿姆帕拉
kehg	科尔霍戈
wn	万宁	渭南
abudaier	阿布戴尔
hpg	和平港
ws	乌苏	文山	韦萨	瓦萨
wt	五台
aemny	阿尔梅尼亚
ALAHSA	ALAHSA	ALAHSA
bdps	布达佩斯
wuchang	五常
axyk	奥西耶克
kelagenfu	克拉根福
wa	武安
wd	文登
wc	五常	吴川	文昌
benba	本巴
wf	潍坊
anman	安曼
aemnl	阿尔梅纳拉
kege	科戈
rushan	乳山
xtl	新特拉
hnw	汉诺威
wlbt	乌兰巴托
elbl	厄勒布鲁
liaoning	辽宁
banama	巴拿马
aiakan	埃阿坎
wlcb	乌兰察布
shaonufeng	少女峰
yindunixiya	印度尼西亚
nanhai	南海
hns	河内市
pamukalai	帕姆卡莱
lundun	伦敦
aym	奥耶姆
hanmierdun	汉密尔顿
changyi	昌邑
pitekaiendaoying	皮特凯恩岛（英）
jiuzhaigou	九寨沟
lutedan	鹿特丹
ty	太原
tx	屯溪	桐乡	泰兴
tz	台州	天长	泰州	滕州	通州	塔兹
lixinjia	利辛加
banteli	班特里
tt	天台	太特
tw	台湾
shengduomei	圣多美
chifeng	赤峰
plmlb	帕拉马里博
hms	胡姆斯
tn	洮南
owld	欧瓦罗岛
tm	图们	天门
tl	桐庐	通辽	铁力	铁岭	铜陵	塔林
ts	台山	唐山	天水	通什
tr	铜仁
bdnf	波多诺伏
tg	泰国
elht	二连浩特
tj	汤加	同江	天津
th	通化
helate	赫拉特
wenlai	文莱
sjchnwslb	圣基茨和尼维斯联邦
tb	廷布
laluotangjiadao	拉罗汤加岛
tc	塔城	太仓	屯昌	桐城	铜川
plje	帕利基尔
ta	泰安
aisaiebiya	埃塞俄比亚
kedw	科尔多瓦
maweng	马翁
qsh	清水河
jinzhou	晋州	锦州
ss	嵊泗	沙市	石狮	石首	鄯善	韶山	苏塞
st	汕头
sy	三亚	上虞	十堰	松原	沈阳	邵阳
sz	宿州	尚志	嵊州	朔州	松滋	深圳	深州	苏州	随州
sw	汕尾	邵武	苏瓦	宿雾
sx	山西	绍兴	陕西
baoding	保定
sl	双辽	商洛	舒兰	首莱
sn	山南	遂宁	萨那
sm	三明	厦门	思茅
lanaka	拉纳卡
hestt	哈尔施塔特
xmn	夏慕尼
sp	四平	松潘
htd	荷台达
maerdaifu	马尔代夫
sr	上饶
sq	商丘	宿迁
sd	苏丹	山东	顺德	上丁	赛达
sc	双城	四川
qtx	青铜峡
sf	什邡
se	撒尔	沙恩	素尔	首尔	苏尔
hake	哈克
sh	三河	上海	四会	沙河	绥化	神户	顺化
niuyue	纽约
flcwf	弗罗茨瓦夫
sg	寿光	韶关
sj	沙加	沙迦
rz	日照	汝州
aisenshitate	艾森史塔特
deqing	德清
hss	红石市
sb	莎巴	沙巴
kasaisai	卡塞塞
qth	七台河
rr	日惹
bdlp	巴德拉坡
rs	瑞士	乳山
xly	叙利亚
Bankok	Bankok	Bankok
budiyaba	布蒂亚巴
lanpeidusa	兰佩杜萨
xindeli	新德里
rq	任丘
hzms	胡志明市
hsd	华盛顿
nanxiong	南雄
rl	瑞丽
rj	瑞金
balagelaoladuo	巴拉哥劳拉多
rh	仁怀
rg	如皋
hsb	海塞卜
rd	瑞典
rc	瑞昌	荣成	仁川
rb	日本
ra	瑞安
plld	普拉兰岛
qy	庆阳	沁阳	清远	千叶	埼玉	七岩
qz	泉州	清镇	琼中	衢州	钦州	青州	庆州
qw	奇旺
qx	栖霞
bmnd	比迷尼岛
wulanbatuo	乌兰巴托
bdkl	拜蒂克洛
aerbuke	阿尔布克
qt	奇台
qn	黔南
qm	且末	清迈
xgll	香格里拉
qj	曲靖	潜江	清津
ql	邛崃	清莱
bilao	比劳
bodedao	伯德岛
qf	曲阜
laergedeersuer	拉尔戈德尔苏尔
hami	哈密
releimi	热雷米
qh	清河	琼海	青海
manchesite	曼彻斯特
qa	迁安
qd	启东	青岛
px	凭祥	萍乡
py	平遥	濮阳
pz	彭州	邳州
akeqiubinsike	阿克秋宾斯克
pt	莆田	帕坦
zhoukou	周口
meishusamoya	美属萨摩亚
pp	佩皮
dibilisi	第比利斯
pq	佩奇
pr	平壤
pula	普拉
ps	磐石	珀斯
wdlydpb	维多利亚大瀑布
rongcheng	荣成
blwez	玻利瓦尔州
mojiadisha	摩加迪沙
fslbd	费萨拉巴德
qwy	齐瓦余
jiaohe	蛟河
ara	昂儒昂
qxn	黔西南
aierfasheer	埃尔法舍尔
yinlaihu	茵莱湖
taonan	洮南
yingkou	营口
xyc	薰衣草
tets	塔尔图斯
zhangqiu	章丘
aptj	阿帕塔基
asa	阿萨奥
xyl	匈牙利
benji	本吉
shengwensente	圣文森特
yangshuo	阳朔
xyt	西雅图
asb	埃斯堡	阿萨布
asp	阿速坡
mengtesailateying	蒙特塞拉特（英）
delingha	德令哈
asl	阿赛拉	奥斯陆
bdgl	波德戈里
mengtegebei	蒙特哥贝
yinchuan	银川
bdgs	比德哥什
akeleili	阿克雷里
jdmd	加德满都
wuxi	无锡
xilandao	西兰岛
plxb	普林西比
qzd	乔治敦
hwn	哈瓦那
ketediwa	科特迪瓦
tlsxs	铁力士雪山
abuzhabi	阿布扎比
songzi	松滋
aolesong	奥勒松
plws	普罗旺斯
bobodiwulasuo	博博迪乌拉索
waerna	瓦尔纳
jitewei	基特韦
apy	阿皮亚
lansi	兰斯
pulishendina	普里什蒂纳
gaozhou	高州
beibeiladi	贝贝拉蒂
wuyi	武义
bujinafasuo	布基纳法索
knad	卡努安岛
wenlaimualaqu	文莱－穆阿拉区
yanzhou	兖州
fuchayila	富查伊拉
gedansike	格但斯克
hsadls	荷属安的列斯
fulimanteer	弗里曼特尔
sugelan	苏格兰
putian	莆田
deze	德尔祖尔
jljs	加拉加斯
buliqidun	布里奇顿
luoxianshi	罗先市
yilishabaigang	伊丽沙白港
zz	周庄	枣庄	株洲	涿州	漳州	郑州	长治
bmdy	百慕大（英）
luang	鲁昂
aernuo	阿尔诺
spls	塞浦路斯
sililanka	斯里兰卡
splt	斯普利特
aws	阿瓦萨
maanshan	马鞍山
awn	艾维浓	阿瓦尼
xihanuke	西哈努克
tnsc	突尼斯城
kunming	昆明
cixi	慈溪
buleida	布雷达
awl	阿瓦雷
shashi	沙市
helan	荷兰
bmsat	班梅苏奥特
zf	中非
zg	中国	自贡	长葛
zh	庄河	珠海	遵化	长海	札幌
danmai	丹麦
asz	阿瑟镇
zb	淄博
xxl	新西兰
zc	增城	诸城	邹城	长春
zd	乍得	中甸	肇东
shms	苏呼米市
jiangyou	江油
ass	阿索萨	阿森松
zhahuang	札幌
yy	余姚	岳阳	益阳	荥阳
zblt	直布罗陀
yz	仪征	兖州	宜州	扬中	扬州	永州	禹州	芽庄
asw	阿斯旺
atm	安提曼
zw	中卫
zy	张掖	招远	枣阳	资阳	遵义
andaoer	安道尔
atk	阿塔克
zx	资兴	钟祥
atl	阿陶罗
jiangsu	江苏
zs	中山	中沙	樟树	舟山	长沙
bayamalei	巴亚马雷
zt	昭通
ate	阿塔尔
gezuodao	戈佐岛
atf	艾图斐
zq	章丘	肇庆	重庆	长崎
pltg	普拉塔港
zp	漳平
ati	阿提
zk	周口
zj	枝江	浙江	湛江	诸暨	镇江
atg	阿塔格
zl	智利	长乐
yg	英国	仰光
yf	云浮
yc	伊春	宜城	宜昌	宜春	应城	榆次	永城	盐城	禹城	运城	银川	阳春
yd	印度	约旦	宜都	英德	亚丁	雅典	云顶
ya	延安	永安	雅安
yb	宜宾	延边	怡保
ats	阿图什
ajestde	埃吉尔斯塔第尔
dongfang	东方
beiyiliusaila	北伊柳塞拉
butalei	布塔雷
xz	徐州	忻州	新郑	西藏
bdbd	巴登巴登
xx	新乡	湘乡	湘西	新泻
xy	信宜	信阳	兴义	咸阳	孝义	新余	新沂
yx	宜兴	玉溪	蔚县
xwy	夏威夷
aodili	奥地利
yw	义乌
jimeineizigang	吉梅内兹港
yt	烟台	鹰潭
ys	偃师	榆树	阳朔	蔚山
yq	焉耆	阳泉
yp	原平
wlshftnqd	瓦利斯和富图纳群岛
yn	越南	云南	伊宁
aiwa(dao)	埃瓦(岛)
ym	也门	义马	玉门
yl	伊朗	伊犁	榆林	玉林	亚伦
kamailong	喀麦隆
weiniyadeerma	维尼亚德尔马
yk	永康	营口	约克
yj	延吉	永济	沅江	阳江
aiaobeide	埃奥贝德
mstlht	马斯特里赫特
bonansa	博南萨
tklx	托克劳（新）
palaoshi	帕劳市
alashanyou	阿拉善右
yinggelan	英格兰
aoqiaoliaosi	奥桥里奥斯
ffd	法法岛
yuzhou	禹州
jijinshaoer	济金绍尔
bokala	博卡拉
xinmin	新民
asby	埃斯比约
asaibaijiang	阿塞拜疆
changning	常宁
msyhsd	美属约翰斯顿
kuermate	库尔马特
acheng	阿城
lafubao	拉夫堡
gdlp(fs)	瓜德罗普(法属)
asdq	阿散蒂区
edacicheng	讹答刺城
hanimaadou	哈霓玛阿都
naniuji	纳纽基
mainamai	麦纳麦
kwtc	科威特城
aerdabile	阿尔达比勒
asen	奥索尔诺
enjiameina	恩贾梅纳
alandisi	阿兰迪斯
yichun	伊春	宜春
ased	埃沙尔登
ablds	阿布鲁代斯
mengtekadini	蒙特卡蒂尼
walisihefutunaqundao	瓦利斯和富图纳群岛
basailuona	巴塞罗纳
tgxjeb	特古西加尔巴
beilawuniweng	贝拉乌尼翁
xet	锡尔特
huadian	桦甸
allplpd	艾林拉帕拉普岛
gljy	格鲁吉亚
hailaer	海拉尔
benjiali	本贾里
halalei	哈拉雷
hlfks	哈利法克斯
bste	巴斯特尔
xdl	新德里
tuozeer	托泽尔
wawawudao	瓦瓦乌岛
saystts	圣奥依斯坦图斯
tashengan	塔什干
faluoqundao	法罗群岛
shengmixieershan	圣米歇尔山
beiergen	卑尔根
xld	西兰岛
shulan	舒兰
keliwoluoge	克里沃罗格
nuoxibeidao	诺西贝岛
ningxia	宁夏
skpl	斯科普里
aklgl	阿卡里瓜拉
zhoushan	舟山
qinhuangdao	秦皇岛
ajan	阿基安尼
kangsaipuxiweng	康塞普西翁
tsny	坦桑尼亚
badelapo	巴德拉坡
yandangshan	雁荡山
qionghai	琼海
ndh	南戴河	诺丁汉
beddle	比尔都达勒尔
neijiang	内江
xiaweiyiqundao	夏威夷群岛
yinsibuluke	因斯布鲁克	茵斯布鲁克
shengaoyisitantusi	圣奥依斯坦图斯
aabd	埃奥贝德
luozi	罗兹
huanghouzhen	皇后镇
ymskl	亚穆苏克罗
yadian	雅典
jiapeng	加蓬
bosenbeimo	博森贝莫
baoji	宝鸡
dibisi	底比斯
naolu	瑙鲁
xjp	新加坡
dblfnk	杜布罗夫尼克
laisite	莱斯特
ajdz	阿加德兹
beiyaweisita	贝亚维斯塔
fdg	梵蒂冈
sitawange	斯塔万格
fdj	佛得角
puaibula	普埃布拉
ajde	阿加迪尔
lmal	拉姆安拉
mjlf	莫吉廖夫
bcwn	博茨瓦纳
eglegl	恩戈罗恩戈罗
bdglc	波德戈里察
qiannan	黔南
nbe	尼泊尔
mjlg	孟加拉国
haodao	豪岛
fcg	防城港
roma	roma	roma
langfang	廊坊
shenghesai	圣何塞
alaiya	阿莱亚
guandaomei	关岛（美）
guilin	桂林
nax	纽埃（新）
akldl	阿克罗蒂里
aske	埃斯克尔
taizhou	台州	泰州
beikaikesi	北凯科斯
puluowangsi	普罗旺斯
jijiali	基加利
shengantang	圣安唐
yueyang	岳阳
luoma	罗马
songpan	松潘
xiyatu	西雅图
gdsk	格但斯克
leikeyaweike	雷克亚未克	雷克雅未克
bakeluode	巴科洛德
liuzhou	柳州
ajny	阿加尼亚
aluba	阿鲁巴
patan	帕坦
dmnj	多米尼加
huzhou	湖州
dmnk	多米尼克
linxia	临夏
suining	遂宁
liaoyuan	辽源
aluolaidao	阿罗赖岛
abtlp	安巴图兰皮
falankefu	法兰克福
balaaona	巴拉奥纳
masidike	马斯蒂克
mingguwu	名古屋
qingdao	青岛
mengjiala	孟加拉
xunyicao	薰衣草
zhangjiajie	张家界
aersuo	阿尔索
huashengdun	华盛顿
anbulishen	安布里什
lilonggui	利隆圭
tumen	图们
jbbw	津巴布韦
yanshi	偃师
xwyqd	夏威夷群岛
xiefeierde	谢菲尔德
balakea	巴拉科阿
yisilanbao	伊斯兰堡
xhnk	西哈努克
asml	阿斯马拉
palao	帕劳
ltwy	拉脱维亚
abadan	阿巴丹
jinbabuwei	津巴布韦
nanchang	南昌
guangdao	广岛
tongliao	通辽
fengning	丰宁
paguba	帕古巴
mdlqd	马德拉群岛
niuai(xinxilanshu)	纽埃(新西兰属)
sidegeermo	斯德哥尔摩
kaimanqundao(yingshu)	开曼群岛(英属)
asny	爱沙尼亚
bodegelicha	波德戈里察
anbilubei	安比卢贝
glsg	格拉斯哥
mqbq	马丘比丘
myt	梅约特
lusaka	卢萨卡
ajjl	阿加贾里
jingzhou	荆州
mzl	满洲里	马朱罗
xinjiaposhi	新加坡市
wnat	瓦努阿图
glld	格陵兰（丹）
jinsidun	金斯敦
dezhou	德州
dabahamadao	大巴哈马岛
bozuomu	博佐姆
bulageweishensike	布拉戈维申斯克
longnan	陇南
mzz	姆祖祖
miluo	汨罗
xby	西班牙
baoan	宝安
aierleiyaer	埃尔雷亚尔
hsghg	黑山共和国
kaonasi	考纳斯
yiselie	以色列
akesumu	阿克苏姆
aboyisuo	阿博伊索
badika	巴蒂卡
laluomana	拉罗马纳
bbyxjny	巴布亚新几内亚
shaoxing	绍兴
dmsg	大马士革
blan	巴拉奥纳
adlsd	安得鲁斯岛
aehsm	阿尔荷塞马
jiayuguan	嘉峪关
glms	格里姆塞
adedaba	阿德达巴
mjds	摩加迪沙
sailusi	塞卢斯
xianli-wugeku	暹粒-吴哥窟
aljess	阿拉加尔萨斯
mxg	墨西哥
glnd	格林纳达	格拉纳达
saisheer	塞舌尔
pulatagang	普拉塔港
shengbidebao	圣彼得堡
kanuandao	卡努安岛
shengtaosha	圣淘沙
danniding	但尼丁
afutala	阿富塔拉
biminidao	比迷尼岛
linfen	临汾
gemeili	戈梅利
myd	马尤岛
youlingdao	幽灵岛
shalala	沙拉拉
siwakepumengde	斯瓦科普蒙德
huangshi	黄石
dilabotu	迪拉伯土
anduluo	安杜洛
luosang	洛桑
shengnigula	圣尼古拉
jining	济宁	集宁
aiyinhuowen	埃因霍温
bopeila	柏培拉
nanxi	南希
glyf	古里耶夫
lmse	利马索尔
daqing	大庆
liweilaerta	里韦拉尔塔
alashanmeng	阿拉善盟
astn	阿斯塔纳
fuluociwafu	弗罗茨瓦夫
qingyuan	清远
wudalianchi	五大连池
kuaopiao	库奥皮奥
paisangdu	派桑杜
kasiteli	卡斯特里
ganpengbi	甘蓬碧
tianzhang	天长
luwangda	卢旺达
yingshuweierjingqundao	英属维尔京群岛
ltlw	罗托鲁瓦
ltly	罗托鲁亚
buluri	布鲁日
swkpmd	斯瓦科普蒙德
hetaida	荷台达
andaoercheng	安道尔城
adiwudao	阿蒂乌岛
bsga	博桑戈阿
bulusaier	布鲁塞尔
guadalahala	瓜达拉哈拉
bemlt	贝尔马立特
daqili	大其力
wsy	维萨亚
skbl	斯卡伯勒
fakalawa(dao)	法卡拉瓦(岛)
bashila	巴士拉
mianzhu	绵竹
bangfula	邦福拉
jiangdou	江都
hasakesitan	哈萨克斯坦
saisaluoniji	塞萨洛尼基
gaoyao	高要
bolaxi	伯拉西
dingxi	定西
blbl	博拉博拉
gelunbiya	哥伦比亚
chitashi	赤塔市
fklw(d)	法卡拉瓦(岛)
yebd	伊尔比德
zalt	祖埃拉特
weiyena	维也纳
glyt	古拉亚特
bsds	波萨达斯
heishangongheguo	黑山共和国
huasha	华沙
wth	渥太华
shajia	沙加	沙迦
bsbm	博森贝莫
mdlgb	曼达勒戈壁
wys	武夷山
aykqg	阿亚库乔港
yantai	烟台
jilongpo	吉隆坡
shangmoluokui	上莫洛奎
wyn	维也纳
abuxinbile	阿布新比勒
wyb	维约堡
qiaozhidun	乔治敦
wyc	五渔村
lmny	罗马尼亚
qumalai	曲麻莱
xianggang	香港
wzs	五指山
zhuzhou	株洲
sjchnws	圣基茨和尼维斯
lichuan	利川
taiyuan	太原
manqini	曼齐尼
beishaer	贝沙尔
xishuangbanna	西双版纳
huaiyin	淮阴
mashamala	玛沙玛拉
kekedao	科科岛
bazhong	巴中
yhnsb	约翰内斯堡
wutelezhi	乌特勒支
feisi	非斯
blgs	布拉干萨
nrw	尼日瓦
laowo	老挝	佬沃
tianzhushan	天柱山
kapuliwei	卡普里维
ziyang	资阳
laheer	拉合尔
qiyu	埼玉
luomei	洛美
andwm(d)	阿内蒂乌姆(岛)
pangbei	庞贝
kexice	科西策
nre	尼日尔
longjing	龙井
anteweipu	安特卫普
hainan	海南
mayd	芒艾亚岛
xinzheng	新郑
tongren	铜仁
bodegeli	波德戈里
aibeibiyin	埃贝比因
jinshi	津市
wdlyz	维多利亚州
lufeng	陆丰
ldlc	吕德里茨
egde	厄瓜多尔
sadumale	萨杜马勒
xian	西安
npl	楠普拉
egdl	恩冈代雷
aqlas	奥桥里奥斯
botuopaxi	博托帕西
wmg	乌姆盖
eky	恩卡伊
bmxes	布米希尔斯
blmt	巴拉米塔
aerta	阿尔塔
baicheng	白城
pannieweiri	潘涅维日
yekck	伊尔库茨克
niema	涅马
feilujie	费卢杰
bsny	波斯尼亚
bllg	布卢拉贡
dierlunwan	迪尔伦湾
milu	秘鲁
els	俄罗斯
pujidao	普吉岛
yasuerqundaopu	亚速尔群岛（葡）
ylsbg	伊丽沙白港
huliyaka	胡利亚卡
jingangshanguanguangdiqu	金刚山观光地区
wns	威尼斯
blkg	布兰卡港
yizhou	宜州
asiwang	阿斯旺
blka	巴拉科阿
pmkl	帕姆卡莱
aoerbao	奥尔堡
hhya	红海沿岸
blcwe	布拉柴维尔
leizhou	雷州
nnj	纳纽基
ems	峨眉山
anhui	安徽
bsln	巴塞罗纳	巴塞罗那
wkl	乌克兰
fhjd	复活节岛
wuyucun	五渔村
nmb	纳米比
weineiruila	委内瑞拉
keluri	克卢日
yingcheng	应城
bulongdi	布隆迪
nmg	内蒙古
ydsybb	亚的斯亚贝巴
dnck	顿涅茨克
wlg	乌拉圭	维拉港
meizhou	梅州
wlt	瓦莱塔
mali	马里
anguila(yingshu)	安圭拉(英属)
baoshan	保山
bljy	巴兰基亚
wlm	瓦勒米
wln	维罗纳
atan	阿图奥纳
hechi	河池
haershitate	哈尔施塔特
dingzhou	定州
egd	恩高岛
nlb	内罗毕
eliteliya	厄立特里亚
nld	瑙鲁岛
bnylk	巴尼亚卢卡
kunshilanzhou	昆士兰州
atba	阿坦布阿
baerdufusi	巴尔杜福斯
liwofu	利沃夫
szdl	苏滋达里
baoqi	包齐
hezuo	合作
mangya	茫崖
boertuohailiweng	波尔托海利翁
tongchuan	铜川
nante	南特
atbl	阿特巴拉
ailinlapalapudao	艾林拉帕拉普岛
nkl	纳库鲁
wendeheke	温得和克
bawst	博阿维斯塔
wnrl	委内瑞拉
ehj	恩海岬
foshan	佛山
renhuai	仁怀
bsks	巴桑库苏
blqd	布里奇顿
beierxieba	贝尔谢巴
mulongdawa	穆隆达瓦
ynqd	尤宁群岛
bskk	比什凯克
nks	诺库斯
keluoniya	科洛尼亚
weiluona	维罗纳
banjiaxi	班加西
jigema	基戈马
anyang	安阳
Florence	Florence	Florence
astlstl	阿斯特拉赛特拉
ltks	劳托卡市
yasongsen	亚松森
engaodao	恩高岛
badiya	芭堤雅
bayannaoer	巴彦淖尔
madangshi	马当市
changdou	昌都
aieraoke	艾尔奥克
dnge	多尼戈尔
blns	巴里纳斯
niujin	牛津
beihai	北海
jianeiliqundao	加那利群岛
fendayisilita	芬达依斯利塔
jinghong	景洪
blnd	贝拉纳岛
feiji	斐济
ltjy	拉塔基亚
aibuha	艾卜哈
feierganna	费尔干纳
xj-gtk	锡金-甘托克
blny	博洛尼亚
guayalameilin	瓜亚拉梅林
wubonu	乌波努
wuganda	乌干达
tongling	铜陵
heyuan	河源
xiaweiyizhou	夏威夷州
donggewa	东戈瓦
jiaerkayou	加尔卡尤
chengde	承德
taertusi	塔尔图斯
simao	思茅
plsdn	普里什蒂纳
balesitan	巴勒斯坦
beijiaya	贝贾亚
atuaona	阿图奥纳
pugan	蒲甘
tlms	特隆姆瑟
qingtongxia	青铜峡
jiana	加纳	戛纳
bululagong	布卢拉贡
kunka	昆卡
pucheng	浦城
aluya	阿鲁亚
saida	赛达
bblszbl	比卜鲁斯（朱拜勒）
jiami	甲米
byglmgzzz	巴音郭楞蒙古自治州
wepls	瓦尔帕莱索
asaila	阿赛拉
nanfa	南法
dandong	丹东
wbn	乌波努
tuerqi	土耳其
llbl	拉利贝拉
bldeswk	布雷达尔斯维克
chongzuo	崇左
moxigecheng	墨西哥城
madeli	马德里
xinghua	兴化
xierhete	锡尔赫特
lankawei	兰卡威
chibi	赤壁
banji	班吉
wuwei	武威
aguasikaliantesi	阿瓜斯卡连特斯
wfd	瓦房店
lingao	临高
bjpx	波基普西
jixi	鸡西
bulagan	布拉干
nwdb	努瓦迪布
wes	威尔士
cangzhou	沧州
heihe	黑河	黑赫
wen	瓦尔纳
shanshan	鄯善
dmnjd	多米尼加岛
yierbide	伊尔比德
sfend	圣费尔南多
nehe	讷河
kemoluo	科摩罗
huishai	会晒
wanxiang	万象
guyuan	固原
wdz	瓦杜兹
lubueryanei	卢布尔雅那
maliujia	马六甲
ggj	刚果（金）
liuniwangfa	留尼旺（法）
malaitadao	马莱塔岛
yuyao	余姚
ggb	刚果（布）
kalaganda	卡拉干达
langnanta	琅南塔
xinbaerhuyouqi	新巴尔虎右旗
bijini	比基尼
nuowei	挪威
abao	阿包
gangguo(bu)	刚果(布)
jingjidao	京畿道
yakaba	亚喀巴
annaxi	安纳西
xkldnyf	新喀里多尼亚（法）
gelasige	格拉斯哥
abby	埃贝比因
slbjws	斯里巴加湾市
wgd	乌干达
luosaliao	罗萨里奥
wgk	吴哥窟
gew	戈尔韦
wgh	温哥华
panshi	磐石
stalb	沙特阿拉伯
bjst	巴基斯坦
angruang	昂儒昂
gem	格尔木
aolanzhimengde	奥兰治蒙德
ouwaluodao	欧瓦罗岛
qitai	奇台
anbatongdelazhaka	安巴通德拉扎卡
atbse	阿特巴萨尔
madajiasijia	马达加斯加
gdm	关岛（美）
wusihuaiya	乌斯怀亚
wjq	五家渠
amahai	阿马海
kuerganqiubie	库尔干秋别
katamakasheng	卡塔马卡省
gdb	歌德堡	哥德堡
jiate	加特
pengheng	彭亨
kangti	康提
geerwei	戈尔韦
wenzhou	温州
xiwa	希瓦
chuzhou	滁州
aisikeer	埃斯克尔
handan	邯郸
laizhou	莱州
chaohu	巢湖
tingbu	廷布
zengcheng	增城
boluoweici	波罗维茨
takedao	塔克岛
btth	本托塔河
luoyang	洛阳
tuwalu	图瓦卢
mknsd	米克诺斯岛	米科诺斯岛
agsklts	阿瓜斯卡连特斯
abde	阿布戴尔
gbd	高碑店
abms	阿布穆萨
akrt	阿克茹特
tjkst	塔吉克斯坦
dahelakequndao	达赫拉克群岛
fengzhen	丰镇
gby	冈比亚
yisitanbuer	伊斯坦布尔
bayiyabina	巴依亚比纳
shoulai	首莱
hhht	呼和浩特
bajiala	巴佳拉
aiwoneisi	埃沃内斯
gelinnada	格林纳达
aohelide	奥赫里德
bulachaiweier	布拉柴维尔
lucheng	潞城
pinghu	平湖
bakewu	巴克乌
jiatu	加途
anqilabei	安其拉贝
pingdu	平度
jiujinshan	旧金山
lamuzhen	拉穆镇
maijia	麦加
bagan	巴甘
yizheng	仪征
erlianhaote	二连浩特
changshu	常熟
saipulusi	塞浦路斯
tlwf	特拉维夫
ashenhabadeshi	阿什哈巴德市
woertequ	沃尔特区
abtdlzk	安巴通德拉扎卡
yingpufengduo	英普丰多
yiyunxiaozhen	依云小镇
xijin-gantuoke	锡金-甘托克
awuawu	阿武阿武
panjin	盘锦
dmflqdd	丹麦法罗群岛（丹）
tuerku	图尔库
yanji	延吉
tlxl	特鲁西洛
badengbadeng	巴登巴登
longhai	龙海
baerboya	巴尔博亚
luxi	潞西
leling	乐陵
nym	尼亚美
xila	希腊
mojiliaofu	莫吉廖夫
hannisibao	翰尼斯堡
apalapuxili	阿帕拉普希里
suoluodi	索罗蒂
shengmalinuo	圣马力诺
ruian	瑞安
fenlan	芬兰
gegong	戈公
fujin	富锦
yanqi	焉耆
xibanya	西班牙
shandong	山东
reshufu	热舒夫
kskys	卡斯卡伊斯
nanao	南澳
nanan	南安
rire	日惹
smxes	圣米歇尔山
xiangfan	襄樊
lagesi	拉各斯
ganlushi	甘露市
lushancheng	绿山城
mafulake	马夫拉客
aeblts	阿尔伯勒塔斯
akll	阿克雷里
aklg	阿卡里瓜
lilanggefu	利朗格弗
anshun	安顺
kcgydq	开城工业地区
ashbds	阿什哈巴德市
maidelin	麦德林
xuliya	叙利亚
ablb	安比卢贝
xini	悉尼
yakeshi	牙克石
nandi	南迪	楠迪
balalai	巴拉莱
abls	安布里什
susai	苏塞
ylhskzzz	伊犁哈萨克自治州
kelakefu	克拉克福	克拉科夫
abmc	阿波美城
hepinggang	和平港
paernu	帕尔努
wenling	温岭
liboweier	利伯维尔
luzhonghai	绿中海
situjiate	斯图加特
asimala	阿斯马拉
hengshui	衡水
bosiniya	波斯尼亚
neimenggu	内蒙古
andaweilasi	安达韦拉斯
ruili	瑞丽
jiuquan	酒泉
Milan	Milan	Milan
guangan	广安
jintan	金坛
zhangsha	长沙
yunding	云顶
asidipalaiadao	阿斯蒂帕莱阿岛
bosanggea	博桑戈阿
zhangshu	樟树
yawende	雅温得
anguilaying	安圭拉（英）
dalanzhadagade	达兰扎达嘎德
xinyang	信阳
bldslf	布拉迪斯拉发
bltly	比勒陀利亚
bonapei	波纳佩
saiweiliya	塞维利亚
lishi	离石
qiandongnan	黔东南
sailalai	塞拉莱
abys	阿博伊索
bldos	布伦迪欧斯
kamishenli	卡米什利
genhe	根河
allkl	阿拉拉库拉
lijia	里加
aplpxl	阿帕拉普希里
pnwr	潘涅维日
miquan	米泉
gangguojin	刚果（金）
huanhui	胡安惠
zhejiang	浙江
yanan	延安
sjbe	桑给巴尔
sydbe	赛义德布尔
rilina	日利纳
jizhou	冀州
weilakelusi	维拉克鲁斯
bywst	贝亚维斯塔
wulatezhongzhen	乌拉特中镇
absl	安波塞利
mskec	密什科尔茨
absg	阿巴斯港
ganjia	甘贾
gelinglandan	格陵兰（丹）
luoshanji	洛杉机	洛杉矶
mllqs	马拉洛奇斯
bbds	巴巴多斯
aegla	埃尔果累阿
alula	阿卢拉
zhangzhou	漳州
dehong	德宏
jishou	吉首
yindu	印度
beilali	贝拉里
anwtkd	埃尼威托克岛
tunisicheng	突尼斯城
ruzhou	汝州
batena	巴特纳
shantou	汕头
jianada	加拿大
aluoa	阿洛阿
tulibuluoke	图利布洛克
banamacheng	巴拿马城
basiteer	巴斯特尔
maiami	迈阿密
fuhuojiedao	复活节岛
anbatulanpi	安巴图兰皮
jingdezhen	景德镇
fodejiao	佛得角
dongtai	东台
tangjia	汤加
masaimala	马赛马拉
lusongdao	吕宋岛
budapeisi	布达佩斯
weidimala	危地马拉
wenchang	文昌
shijiazhuang	石家庄
klwlg	克里沃罗格
saibuha	塞布哈
llmn	拉罗马纳
namibi	纳米比
mltny	毛里塔尼亚
weiduoliyazhou	维多利亚州
jiyuan	济源
mangaiyadao	芒艾亚岛
suhumishi	苏呼米市
wens	维尔纽斯
qiqihaer	齐齐哈尔
fuyun	富蕴
shangluo	商洛
qianxinan	黔西南
apiya	阿皮亚
lingyuan	凌源
mashaoerqundao	马绍尔群岛
bulufeierci	布鲁菲尔茨
glby	哥伦比亚
wuyishan	武夷山
aketao	阿克套
dacheng	大城
bageda	巴格达
shengfeiernanduo	圣费尔南多
hebei	河北
bakeer	巴克尔
kuazulu-nataersheng	夸祖鲁-纳塔尔省
heben	赫本
dmnjghg	多米尼加共和国
enduola	恩多拉
fsblnxy	法属波利尼西亚
anbatumaiyindi	安巴图迈茵蒂
aeghd	艾尔格哈达
gujiao	古交
fms	福莫萨
kasabulanka	卡萨布兰卡
deliboli	的黎波里
tlhm	特隆海姆
bolaigu	波来古
paluo	帕罗
bahedaer	巴赫达尔
shenghelenaying	圣赫勒拿（英）
btpx	博托帕西
nkalf	努库阿洛法
yicheng	宜城
kplw	卡普里维
dishi	迪石
mindandao	民丹岛
tnnlf	塔那那利佛
anguo	安国
maputuo	马普托
bkks	北凯科斯
zhongsha	中沙
huizhou	徽州	惠州
masai	马赛
huaxinqiyan	华欣七岩
bubaji	布巴基
duominijiadao	多米尼加岛
jedhp	加尔达湖畔
haerbin	哈尔滨
meiyuete	梅约特
hejian	河间
wwwd	瓦瓦乌岛
dunhua	敦化
sdmhplxb	圣多美和普林西比
haimen	海门
adnag	安东尼奥港
zhongdian	中甸
ailiwen	埃里温
conghua	从化
baishawa	白沙瓦
ketuonu	科托努
manzhouli	满洲里
shengbaoluo	圣保罗
falu	法鲁
btjf	巴坦加弗
alusha	阿鲁沙
xinxiang	新乡
masikaku	马斯喀绔
aertai	阿尔泰
llgf	利朗格弗
jjse	济金绍尔
malaiyiqu	马来奕区
asbj	阿塞拜疆
abtbd	阿伯塔巴德
flb	菲律宾
aisen	埃森
fld	弗里敦
asbd	阿什伯顿
fll	发罗拉
matinike(fashu)	马提尼克(法属)
jinhua	金华
flj	费卢杰
abzb	阿布扎比
bkld	巴科洛德
jianqiao	剑桥
huludao	葫芦岛
rizhao	日照
bkll	巴克拉兰
intelaken	intelaken	intelaken
shengsi	嵊泗
klwfl	卡罗维发利
kebuduo	科布多
mangshi	芒市
yingyang	荥阳
monage	摩纳哥
sulinan	苏里南
donglundun	东伦敦
gente	根特
dingan	定安
laisuotuo	莱索托
nabulusi	纳布卢斯
haidijiao	海地角
pulinxibi	普林西比
sbdb	圣彼得堡
aerbaha	阿尔巴哈
tiantai	天台
mtkdn	蒙特卡蒂尼
wetq	沃尔特区
bkne	比卡内尔
nxbd	诺西贝岛
nuowoxibiersike	诺沃西比尔斯克
wuzhou	梧州
emeishan	峨眉山
kalongjia	卡龙加
jiaxing	嘉兴
bbld	贝贝拉蒂
atushen	阿图什
haidong	海东
suzhou	宿州	苏州
longyan	龙岩
daniding	达尼丁
xinjiapo	新加坡
liyeka	里耶卡
nakulu	纳库鲁
kelamayi	克拉玛依
lindi	林迪
puneika	普那卡
shenhu	神户
jineiyabishao	几内亚比绍
bisa	比萨
yiyang	益阳
mshd	马什哈德
buwakai	布瓦凯
stlsb	斯特拉斯堡
aldy	奥拉迪亚
doudongqu	都东区
mdjsj	马达加斯加
tkmst	土库曼斯坦
palunke	帕伦克
jinchang	金昌
linzhi	林芝
wnydem	维尼亚德尔马
byml	巴亚马雷
latajiya	拉塔基亚
tianebao	天鹅堡
nuokusi	诺库斯
alet	阿莱尔塔
gtnm	关塔那摩
aguakelala	阿瓜克拉拉
byne	巴彦淖尔
bata	巴塔
ppna	佩皮尼昂
saineijiaer	塞内加尔
ysblk	因斯布鲁克	茵斯布鲁克
shawayi	沙娃伊
bosadasi	波萨达斯
fklqd	福克兰群岛
achutupo	阿楚图珀
otelaisi	噢特莱斯
liusen	琉森
bajisitan	巴基斯坦
linhai	临海
xbyg	西班牙港
asitana	阿斯塔纳
balesitanguo	巴勒斯坦国
algd	埃里甘地
aodaliya	澳大利亚
nmby	纳米比亚
banjialuoer	班加罗尔
linci	林茨
base	巴色
hunan	湖南
basi	巴斯
masitelihete	马斯特里赫特
xingtai	邢台
deheilan	德黑兰
bamo	八莫
lbx	莱比锡
lby	利比亚
dbl	都柏林
dbf	奠边府
zhongqing	重庆
dbg	多巴哥
xiangxi	湘西
mskk	马斯喀绔
mlke	马拉卡尔
dbs	调兵山	底比斯
mlkd	马略卡岛
eexj	俄尔辛基
qingzhou	青州	庆州
paduowa	帕多瓦
aljp	阿拉吉普	阿雷基帕
baotou	包头
mslt	米苏拉塔
shengfeilipei	圣费利佩
dal	杜阿拉
spaehmkld	圣皮埃尔和密克隆岛
jiduo	基多
legdese	拉尔戈德尔苏尔
linan	临安
stlnd	圣托里尼岛
asupo	阿速坡
keluoer	科罗尔
bmlynm	北马里亚纳（美）
bulajia	布拉加
alamutu	阿拉木图
msml	玛沙玛拉	马赛马拉
alld	阿罗赖岛
kuche	库车
jieyang	揭阳
lad	罗安达
aosilu	奥斯陆
ddq	都东区
bapd	北安普顿
ddw	东帝汶
kegqb	库尔干秋别
hailin	海林
taiyangcheng	太阳城
ajiadier	阿加迪尔
lat	罗阿坦
hefei	合肥
tkshkksqdy	特克斯和凯科斯群岛（英）
jinshasa	金沙萨
mlks	马拉喀什
alkd	艾芦克岛
balawang	巴拉望
amstd	阿姆斯特丹
lbg	卢班戈
lbm	卢博莫
alkq	阿拉卡茄
fsgyn	法属圭亚那
fukang	阜康
lbn	黎巴嫩
lbt	拉巴特
lbs	拉巴斯
baojiao	宝礁
jida	吉达
jibuti	吉布提
alalakula	阿拉拉库拉
daleisisalamu	达累斯萨拉姆
wuhai	乌海
wuhan	武汉
bohei	波黑
beipiao	北票
aerbamingqi	阿尔巴明契
aomen	澳门
lusenbao	卢森堡
malua	马鲁阿
shenzhen	深圳
xjps	新加坡市
zhanjiang	湛江
dehui	德惠
cts	赤塔市
alnk	阿拉努卡
kwh	科维哈
malawei	马拉维
almt	阿拉木图
natptp(d)	纽阿托普塔普(岛)
kwc	考文垂
csx	冲绳县
bitamu	比塔姆
kelunpo	科伦坡
duobage	多巴哥
sdyg	圣地亚哥
mtnk(fs)	马提尼克(法属)
manila	马尼拉
mengzhou	孟州
yuxi	玉溪
liping	黎平
alpy	奥林匹亚
yixing	宜兴
kte	卡塔尔
bulusilaguna	布鲁斯拉古纳
doubolin	都柏林
aerbina	阿尔比纳
kss	卡塞塞
ljsx	拉杰沙希
jian	吉安	集安
faguo	法国
boendai	博恩代
ksn	卡萨内
ksm	卡萨马
ksl	科斯雷
laohekou	老河口
xizang	西藏
bywk	比亚文克
wotefude	沃特福德
aolan	奥兰
bolabola	博拉博拉
msbk	莫桑比克
ktn	科托努
huangyan	黄岩
ktm	喀土穆
houen	候恩
abomeicheng	阿波美城
madelaqundaopu	马德拉群岛（葡）
bazhou	霸州
dibai	迪拜
dangguola	当果拉
luquan	鹿泉
guiyang	贵阳
shangrao	上饶
liwupu	利物浦
eguaduoer	厄瓜多尔
weihai	威海
linhe	临河
ruijin	瑞金
aebssm	阿尔卑斯山脉
kyn	卡亚尼
kaiyuan	开原	开远
xianning	咸宁
lbwe	利伯维尔
penglai	蓬莱
menggu	蒙古
xinxilan	新西兰
suolinuo	索里诺
fldwstk	符拉迪沃斯托克
aerjiliya	阿尔及利亚
weinisi	威尼斯
aseby	埃塞俄比亚
xinjiang	新疆
bylsl	北伊柳塞拉
bulundiousi	布伦迪欧斯
asensong	阿森松
haining	海宁
msdk	马斯蒂克
xinxie	新泻
hailun	海伦
baxiliya	巴西利亚
na(xxls)	纽埃(新西兰属)
feijiqundao	斐济群岛
buladisilafa	布拉迪斯拉发
aidemengdun	埃德蒙顿
baxi	巴西
moputi	莫普提
beierqi	贝尔齐
kxc	科西策
alty	阿鲁图亚
mldw	穆隆达瓦
xilinhaote	锡林浩特
hunchun	珲春
andelusidao	安得鲁斯岛
kwt	科威特
jineiya	几内亚
beilayela	贝拉耶拉
jiaozuo	焦作
aleijipa	阿雷基帕
alsy	阿拉善右
kataer	卡塔尔
chaoxian	朝鲜
basike	巴斯克
xiangshan	象山
alsm	阿拉善盟
eeds	鄂尔多斯
lpn	蓝毗尼
lps	六盘水
tazi	塔兹
aksm	阿克苏姆
kqbb	科恰班巴
smeh	撒马尔罕
lblb	朗勃拉邦	琅勃拉邦
dirong	第戎
baieluosi	白俄罗斯
eerduosi	鄂尔多斯
pingyao	平遥
lbln	兰巴雷内
pizhou	邳州
helutefangdan	赫鲁特方丹
secb	萨尔茨堡
khmek	卡哈马尔卡
mengbasa	蒙巴萨
nantong	南通
aishaerdeng	埃沙尔登
fenghua	奉化
xkldny	新喀里多尼亚
alaguayina	阿拉瓜依纳
abuleiaoyuesi	阿布雷奥约斯
damashige	大马士革
jieke	捷克
balanjiya	巴兰基亚
badewang	巴德望
cmt	策马特
lnk	拉纳卡
laixi	莱西
alabolianheqiuzhangguo	阿拉伯联合酋长国
basailuonei	巴塞罗那
qianye	千叶
aepek	阿尔普尔科
anuhadaodujiashengdi	阿努哈岛度假胜地
saierweiya	塞尔维亚
shengzhou	嵊州
daxidi	大溪地
yumen	玉门
lnt	琅南塔
houma	侯马
lmn	里米尼
ganbierdao	甘比尔岛
leqing	乐清
aboding	阿伯丁
lml	罗梅利
aebny	阿尔巴尼亚
lmd	龙目岛
slmqd	所罗门群岛
lmz	拉穆镇
actp	阿楚图珀
siluowenniya	斯洛文尼亚
kanpala	坎帕拉
luofanniemi	罗凡涅米
fdyslt	芬达依斯利塔
kayani	卡亚尼
askshm	奥斯卡斯哈门
malindi	马林迪
dongguan	东莞
ltw	立陶宛
jifu	基辅
bulankagang	布兰卡港
bujiasi	布加斯
tjtbd	汤加塔布岛
bqbl	布琼布拉
fengcheng	丰城	凤城
anshan	鞍山
flxsd	弗朗西斯敦
shangding	上丁
lsj	冷水江	洛杉机	洛杉矶
eegn	额尔古纳
buhala	布哈拉
lsk	卢萨卡
tengzhou	滕州
zunyi	遵义
tianshui	天水
lst	莱索托	莱斯特
bentuotahe	本托塔河
lsw	拉塞瓦
laiwu	莱芜
boduonuofu	波多诺伏
yongan	永安
kuerle	库尔勒
alashan	阿拉善
guadeluopufa	瓜德罗普（法）
gaocheng	藁城
ltd	罗塔岛	鹿特丹
libiya	利比亚
qufu	曲阜
saerdao	萨尔岛
lse	卢塞恩
lsd	吕宋岛
lsc	绿山城
beiningcheng	贝宁城
lsb	卢森堡	里斯本
tumushuke	图木舒克
lzdsd	列支敦士登
bohemudao	波荷木岛
jieer	杰尔
riben	日本
yueke	约克
jier	基尔
lbly	利比里亚
moerduowa	摩尔多瓦
adwls	安达韦拉斯
yuci	榆次
shengduomeijipulinxibi	圣多美及普林西比
jifa	基法
dbhmd	大巴哈马岛
manixijiqundao	马尼希基群岛
luotuoluya	罗托鲁亚
xinkaliduoniya	新喀里多尼亚
bamiyang	巴米扬
lishui	丽水
fulidun	弗里敦
lhe	拉合尔
bominghan	伯明翰
lhk	老河口
tongbutu	通布图
hawanei	哈瓦那
mufuwei	姆富韦
lgs	拉各斯
jinzhong	晋中
weihui	卫辉
bjly	保加利亚
aerkaleike	阿尔卡雷克
smld	圣玛丽岛
aebhl	阿尔拜赫雷
weiyuebao	维约堡
kapa	库奥皮奥
beiertua	贝尔图阿
annaba	安纳巴
smlk	上莫洛奎
atghbbd	安提瓜和巴布达
zhongxiang	钟祥
bjle	班加罗尔
smln	圣马力诺
abmmhj	阿贝马马环礁
aglnw	阿格里尼翁
dlbt	迪拉伯土
lfy	老佛爷
smdld	苏门答腊岛
haiya	海牙
yemen	也门
mosike	莫斯科
dlbl	的黎波里
kashan	喀山
shawannaji	沙湾拿吉
haixi	海西
aoerdao	奥尔岛
lfb	拉夫堡
posi	珀斯
lingwu	灵武
ceb	查尔巴
beiermeihuo	贝尔梅霍
bali	巴黎
bocheng	博城
blstg	巴勒斯坦国
fjqd	斐济群岛
nansha	南沙
xteb	新天鹅堡
bayanhonggeer	巴颜洪格尔
baku	巴库
dongjing	东京
kalakesigang	卡拉克斯港
moerben	墨尔本
jiaerdahupan	加尔达湖畔
kjlh	克久拉霍
jingwangang	鲸湾港
maertadao	马耳他岛
shishi	石狮
xinchang	新昌
walaita	瓦莱塔
mcst	曼彻斯特
gejiu	个旧
bulantaier	布兰太尔
cgf	楚格峰
halaerlin	哈拉尔林
llg	利隆圭
addb	阿德达巴
waduzi	瓦杜兹
aebmq	阿尔巴明契
duala	杜阿拉
aneike	阿那科
ksblk	卡萨布兰卡
lks	卢克索
mstd	姆斯特丹
albh	阿鲁巴（荷）
mste	莫斯塔尔
guangzhou	广州	光州
lkw	兰卡威
daxian	达县
aerjier	阿尔及尔
zigong	自贡
jiducheng	基督城
albb	奥林波堡
bael	北爱尔兰
yongcheng	永城
ageliniweng	阿格里尼翁
aoxiyeke	奥西耶克
kesilei	科斯雷
bishenkaike	比什凯克
chongzhou	崇州
ljn	里加纳	卢加诺
guigang	贵港
aejly	阿尔及利亚
luotuoluwa	罗托鲁瓦
basaier	巴塞尔
daxinganling	大兴安岭
xbdq	西部地区
maqiubiqiu	马丘比丘
dybke	迪亚巴克尔
qingzhen	清镇
aishaniya	爱沙尼亚
suizhou	随州
alds	阿兰迪斯
jiadameisilaocheng	加达梅斯老城
jimo	即墨
kamagui	卡马圭
dexing	德兴
dlsslm	达累斯萨拉姆
kelaimeng	克莱蒙
wanning	万宁
jiademandou	加德满都
geft	戈尔菲托
adec	安道尔城
jinggangshan	井冈山
luosuo	罗索
maermo	马尔默
mkns	梅克内斯
ylsd	亚历山大	易路斯岛
hnsb	翰尼斯堡
ylsl	耶路撒冷
aluowei	阿洛维
yilake	伊拉克
manisalaisi	马尼萨莱斯
xbehyq	新巴尔虎右旗
yalun	亚伦
baise	百色
liuan	六安
mtle	蒙特利尔
shalaoyue	沙捞越
shuangliao	双辽
latuoweiya	拉脱维亚
beianpudun	北安普顿
xianyang	咸阳
leiyang	耒阳
slrw	萨拉热窝
shengmalinuoshi	圣马力诺市
tkshkksqd	特克斯和凯科斯群岛
baleila	巴雷拉
qinghe	清河
xingping	兴平
binzhou	滨州
yuanping	原平
mad	马埃岛
adijiasi	阿蒂加斯
aiyin	艾因
kemoduo	科摩多
mas	马鞍山
aletai	阿勒泰
mam	迈阿密
meiguigang	玫瑰港
tamalinde	塔马林德
ataoluo	阿陶罗
fenyang	汾阳
tieli	铁力
tianningdao	天宁岛
bidegeshen	比德哥什
mbs	蒙巴萨
beimaliyanamei	北马里亚纳（美）
yilang	伊朗
zhijiage	芝加哥
pafusi	帕福斯
huolinguole	霍林郭勒
qitaihe	七台河
akulei	阿库雷
enhaijia	恩海岬
atfjst	安托法加斯塔
buernuo	布尔诺
kksqd	科科斯群岛
huaihua	怀化
jieshou	界首
daan	大安
mdd	民丹岛
lianyuan	涟源
swly	塞维利亚
bulaide	布莱德
kelaipeida	克莱佩达
adjs	阿蒂加斯
beitu	贝图
muzuzu	姆祖祖
awasa	阿瓦萨
deguo	德国
fujian	福建
zaoyang	枣阳
kashen	喀什
tajikesitan	塔吉克斯坦
mds	马当市
mdj	牡丹江
mdn	麦地纳
aodesa	敖德萨
mdl	麦德林	曼德勒	马德里
edl	恩多拉
telaweifu	特拉维夫
musitedan	姆斯特丹
chishui	赤水
cenxi	岑溪
weierniusi	维尔纽斯
meb	墨尔本
mandele	曼德勒
tjkj	提吉克贾
madelaqundao	马德拉群岛
bulisiban	布里斯班
met	马耳他
zhangle	长乐
bhmd	波荷木岛
datong	大同
xl-wgk	暹粒-吴哥窟
kaerxi	卡尔希
mem	马尔默
adle	阿德拉尔
adld	阿德莱德
mswejqd	美属维尔京群岛
edp	恩德培
hongjiang	洪江
anuladepule	阿努拉德普勒
yhnsbs	约翰内斯堡市
meishuweierjingqundao	美属维尔京群岛
yajiada	雅加达
siweishilan	斯威士兰
suifenhe	绥芬河
mfw	姆富韦
zaozhuang	枣庄
neiqu	那曲
adly	澳大利亚
zunhua	遵化
kunshan	昆山
gaoyou	高邮
admd	埃德蒙顿
yangguang	仰光
asitelasaitela	阿斯特拉赛特拉
debulesen	德布勒森
aidemite	埃德米特
mengmai	孟买
gemashi	戈马市
xinmi	新密
bishao	比绍
kehetelayaerwei	科赫特拉亚尔韦
jiangmen	江门
sagelebu	萨格勒布
hengyang	衡阳
mednd	马尔多纳多
tzg	太子港
slxy	圣卢西亚
admt	埃德米特
ruishi	瑞士
weisa	韦萨
keluodiya	克罗地亚
zhangqixian	长崎县
tzs	天柱山
dxd	大溪地
xinle	新乐
lwd	卢旺达
lwf	利沃夫
tze	托泽尔
heijiao	黑角
antiman	安提曼
dwt	蒂瓦特
fuyang	富阳	阜阳
adns	安德内斯
mbbn	姆巴巴内
mbdk	姆班达卡
dwd	达维德
lxj	利辛加
wendeng	文登
anning	安宁
shaowu	邵武
haisaibu	海塞卜
lwp	利物浦
zhaerka	扎尔卡
zhangye	张掖
ampl	阿姆帕拉
tianjin	天津
babuyaxinjineiya	巴布亚新几内亚
gangcha	刚察
lyd	利雅得
lincang	临沧
swnj	沙湾拿吉
jiasha	加沙
lyk	里耶卡
lnw(fs)	留尼汪(法属)
lyg	连云港	路易港
xinji	辛集
aisitejiaocheng	埃斯特角城
malakashen	马拉喀什
lxs	罗先市
meishuyuehansidun	美属约翰斯顿
tuokelaoxin	托克劳（新）
sanya	三亚
gelujiya	格鲁吉亚
lzh	绿中海
boshidun	波士顿
haikou	海口
rugao	如皋
yisitanbao	伊斯坦堡
yelusaleng	耶路撒冷
palijier	帕利基尔
shengdiyagedao	圣地亚哥岛
swst	圣维森特	圣文森特
bynsals	布宜诺斯艾利斯
mianlanlao	棉兰老
bjfydeystl	博加福约杜尔－伊斯特里
lasa	拉萨
kaifeng	开封
mtgb	蒙特哥贝
weilankulushen	维兰库卢什
haidi	海地
jizhoudao	济州岛
shengqiaozhi	圣乔治
huixian	辉县
zhangqi	长崎
chaoyang	朝阳
yingguo	英国
xiaosong	小松
bogai	博盖
beilu	贝鲁
yongji	永济
tyc	太阳城
shaba	莎巴	沙巴
guandao	关岛
beipa	北帕
wanyuan	万源
boluotao	博洛陶
boerduo	波尔多
aneidiwumu(dao)	阿内蒂乌姆(岛)
buqiongbula	布琼布拉
hanbao	汉堡
atly	安塔利亚
maerta	马耳他
tonghua	通化
dilanei	地拉那
nankang	南康
shashibiyaguju	莎士比亚故居
caiermate	采尔马特
alaoka	阿劳卡
hegang	鹤岗
baercesi	巴尔策斯
wdmlc	危地马拉城
dzl	丹兹利
masailu	马塞卢
swsl	斯威士兰
twl	图瓦卢
chenzhou	郴州
nanjing	南京
kaerkasong	卡尔卡松
haifa	海法
taite	太特
aoerta	奥尔塔
xingan	兴安
beini	贝尼
balisaer	巴里萨尔
taian	泰安
yunfu	云浮
kaili	凯里
xlht	锡林浩特
mpt	马普托	莫普提
adwd	阿蒂乌岛
shenzhou	深州
weiduoliyadapubu	维多利亚大瀑布
azhiman	阿治曼
yongkang	永康
wuxue	武穴
longyou	龙游
aleinasijiao	阿雷纳斯角
faluola	发罗拉
abirang	阿比让
adelaer	阿德拉尔
afolei	阿佛雷
lyrnl	里约热内卢
dql	大其力
wumugai	乌姆盖
maoming	茂名
yading	亚丁
baermasaida	巴尔马塞达
fuladiwosituoke	符拉迪沃斯托克
shaen	沙恩
tsg	塔什干
taiwanluyou	台湾旅游
otls	噢特莱斯
shaoshan	韶山
dnd	但尼丁	达尼丁
beining	贝宁	北宁
pulaya	普拉亚
nujiang	怒江
mse	摩苏尔
msc	麦孙城
mqd	马其顿
weidimalacheng	危地马拉城
saisheerqundao	塞舌尔群岛
slbb	塞勒巴比
yuenan	越南
gelanada	格拉纳达
yierkucike	伊尔库茨克
dinieboluobideluofusike	第聂伯罗彼得罗夫斯克
zhaodong	肇东
mqn	曼齐尼
luohe	漯河
wugang	武冈	舞钢
boluobennisabandao	波罗奔尼萨半岛
gangguo(jin)	刚果(金)
fashubolinixiya	法属波利尼西亚
luoha	洛哈
tme	泰美尔
xshl	西撒哈拉
baerdailei	巴尔代雷
mtl	蒙特雷	蒙特勒
dsq	大石桥
tlz	图卢兹
nkse	纽卡斯尔
mtg	蒙特港
xilinguole	锡林郭勒
beihengaopuzuomu	贝亨奥普佐姆
sipulite	斯普利特
abotabade	阿伯塔巴德
aoyemu	奥耶姆
tnd	天宁岛
msk	莫斯科	明斯克
msl	马塞卢
atwp	安特卫普
lsln	拉塞雷纳
aw(d)	埃瓦(岛)
tekesihekaikesiqundaoying	特克斯和凯科斯群岛（英）
mtd	马塔迪
shahe	沙河
aheqi	阿合奇
bikaneier	比卡内尔
weige	维哥
tns	突尼斯
jiaergeda	加尔各答
zhumadian	驻马店
mnste	莫纳斯提尔
cemt	采尔马特
jnlqd	加那利群岛
bafusamu	巴富萨姆
bbdwls	博博迪乌拉索
biyawenke	比亚文克
kmqd(ys)	开曼群岛(英属)
deerzuer	德尔祖尔
zhangping	漳平
aolinbobao	奥林波堡
yajiadeer	亚加的尔
lsla	罗萨里奥
guba	古巴
jianpuzhai	柬埔寨
jialalabade	贾拉拉巴德
cdjny	赤道几内亚
slfk	斯洛伐克
qinghai	青海
batuna	巴图纳
wuyuan	婺源
jilidao	基利岛
tpl	坦佩雷
kaduna	卡杜纳
maolitaniya	毛里塔尼亚
anbatuo	安巴托
dsb	杜尚别
peme	帕尔马尔
gulayate	古拉亚特
suofeiya	索非亚
dgw	东戈瓦
anqiu	安丘
mhk	梅河口
yidali	意大利
aman	阿曼
awani	阿瓦尼
engeluoengeluo	恩戈罗恩戈罗
moluoni	莫罗尼
kaita	凯塔
agl(ys)	安圭拉(英属)
dgl	当果拉
mhd	曼哈顿
alnsj	阿雷纳斯角
anhddjsd	阿努哈岛度假胜地
xixiadaxiagu	西峡（大峡谷）
yangzhong	扬中
shengmading	圣马丁
xsbn	西双版纳
nkxy	尼科西亚
mudanjiang	牡丹江
zhijiang	枝江
qingmai	清迈
mgw	名古屋
zhangjiagang	张家港
sanei	萨那
qianan	迁安
bedfs	巴尔杜福斯
mgg	玫瑰港
hexj	赫尔辛基
dhl	德黑兰	达赫拉
aeby	奥尔波依
zhangge	长葛
dala	达拉
mengjialaguo	孟加拉国
bilishi	比利时
duominijiagongheguo	多米尼加共和国
aebn	阿尔比纳
dali	大理
mlywqc	玛丽亚温泉城
aebh	阿尔巴哈
aebk	阿尔布克
ymny	亚美尼亚
shengmalidao	圣玛丽岛
tkd	塔克岛
luzhou	泸州
mjl	孟加拉
pengba	彭巴
daka	达卡
biletuoliya	比勒陀利亚
malei	马累
xisahala	西撒哈拉
lingbao	灵宝
gangbiya	冈比亚
alepo	阿勒颇
sanhe	三河
ailigandi	埃里甘地
eluosi	俄罗斯
aershan	阿尔山
tlw	塔拉瓦
nanpula	楠普拉
hnyl	霍尼亚拉
aeak	艾尔奥克
guizhou	贵州
bujialesite	布加勒斯特
kaneiluoneisi	卡内洛内斯
tlf	吐鲁番
agkll	阿瓜克拉拉
ayakuqiaogang	阿亚库乔港
tld	托莱多
heze	菏泽
dld	多伦多	东伦敦
mlw	马拉维
tek	图尔库
gaodang	高当
teb	天鹅堡
mlr	马兰热
mll	棉兰老
qingyang	庆阳
liyuereneilu	里约热内卢
mln	莫罗尼
boernienkongni	伯尔尼恩孔尼
mlg	摩洛哥
beifangcheng	北方城
mlj	马六甲
mld	马林迪
liupanshui	六盘水
dongjiadapu	东加大埔
huozhou	霍州
mla	马鲁阿
jidila	基蒂拉
mlb	马里博	马拉博
xinyu	新余
sifakesi	斯法克斯
bodunwude	伯顿伍德
xichang	西昌
slla	塞拉利昂
linjiang	临江
sanming	三明
mkl	木卡拉
xinyi	信宜	新沂
dls	都拉斯
monasitier	莫纳斯提尔
dln	地拉那
mkd	毛凯岛
endekahan	恩德卡汗
tet	塔尔图
sllk	斯里兰卡
dlh	德令哈
teq	土耳其
ltnjl	腊塔纳基里
moluoge	摩洛哥
linzhou	林州
dje	丹吉尔
ketelaike	科特赖克
mns	玛瑙斯
patelei	帕特雷
kejiulahuo	克久拉霍
yilusidao	易路斯岛
wuzibiekesitan	乌兹别克斯坦
tukumansitan	土库曼斯坦
mnl	马尼拉
zhaotong	昭通
mnm	麦纳麦
xlgl	锡林郭勒
basongge	巴松戈
beilanadao	贝拉纳岛
yizimier	伊兹密尔
klykd	卡里亚库岛
mng	摩纳哥	马那瓜
mnh	慕尼黑
huanghua	黄骅
mukala	木卡拉
dke	达喀尔
akqbsk	阿克秋宾斯克
djy	都江堰
taimeier	泰美尔
sdmg	圣多明各
bumixiersi	布米希尔斯
sdml	萨杜马勒
ytlk	因特拉肯
jurong	句容
yangchun	阳春
verona	verona	verona
huhehaote	呼和浩特
meiguo	美国
slnk	萨洛尼卡
duominike	多米尼克
djk	丹江口